# Define the namespace
namespace  cars

# Define expiry just above the set of redirects for which it applies

# Environments
#env  test  testwww.volvocars.com
#env  qa  qawww.volvocars.com
#env  prod  www.volvocars.com

/il/cars/xc40-hybrid/  /il/cars/plug-in-hybrids/  *
/il/cars/xc40-hybrid/interior-design/  /il/cars/plug-in-hybrids/  *
/il/cars/xc40-hybrid/features/  /il/cars/plug-in-hybrids/  *
/tw/cars/suv/  /tw/v/cars/suv   *
/cl/cars/sedan/  /cl/  *
/mx/cars/sedan/ /mx/  * 
/mt/cars/sedan/  /mt/  *
/il/cars/xc40-hybrid  /il/cars/xc40-electric/  *
/il/cars/xc40-hybrid/interior-design  /il/cars/xc40-electric/  *
/il/cars/xc40-hybrid/features  /il/cars/xc40-electric/  *
/it/cars/v60-cross-country/specifications  /it/cars/v60-cross-country/  *
/hu/cars/xc40-hybrid/specifications  /hu/cars/xc40-hybrid/  *
/en-eg/cars/v60/specifications  /en-eg/cars/v60/  *
/ar-eg/cars/v60/specifications  /ar-eg/cars/v60/  *
/es/cars/s60/specifications  /es/cars/s60/  *
/es/cars/s60-hybrid/specifications  /es/cars/s60-hybrid/  *
/es/cars/s90-hybrid/specifications  /es/cars/s90-hybrid  *
/es/cars/s90/specifications  /es/cars/s90/  *
/es/cars/V60-cross-country/specifications  /es/cars/v60-cross-country/  *
/es/cars/V90-cross-country/specifications  /es/cars/v90-cross-country/  *
/cz/cars/c40-electric  /cz/cars/ec40-electric/  *
/uk-ua/cars/s90/specifications/  /uk-ua/  *
/uk-ua/cars/s90-hybrid/specifications/  /uk-ua/  *
/uk-ua/cars/v60-hybrid/specifications/  /uk-ua/  *
/al/cars/s60-hybrid/	/al/cars/sedan/  *
/pl/cars/xc40-electric  /pl/cars/ex40-electric/  *
/fr-ch/cars/v60-cross-country/specifications  /fr-ch/cars/v60-cross-country/  *
/it-ch/cars/v60-cross-country/specifications  /it-ch/cars/v60-cross-country/  *
/de-ch/cars/v60-cross-country/specifications  /de-ch/cars/v60-cross-country/  *
/fr-ch/cars/v90-cross-country/specifications  /fr-ch/cars/v90-cross-country/  *
/it-ch/cars/v90-cross-country/specifications  /it-ch/cars/v90-cross-country/  *
/cz/cars/s60-hybrid/specifications  /cz/cars/s60-hybrid/  *
/cz/build/s60-hybrid  /cz/build  *
/cz/cars/s60/specifications  /cz/cars/s60  *
/cz/build/s60  /cz/build  *
/ar-kw/cars/s60-hybrid/	/ar-kw/cars/sedan/  *
/ar-kw/cars/xc60-hybrid/	/ar-kw/cars/suv/  *
/ar-qa/cars/s90-hybrid/	/ar-qa/cars/sedan/  *
/at/cars/s60-hybrid/Specification/	/at/cars/s60-hybrid/specifications/  *
/at/cars/s90-hybrid/Specification/	/at/cars/s90-hybrid/specifications/  *
/at/cars/xc40-electric/	/at/cars/ex40-electric/  *
/at/cars/xc60-hybrid/Specification/	/at/cars/xc60-hybrid/specifications/  *
/at/cars/xc90-Hybrid/Specification/	/at/cars/xc90-hybrid/specifications/  *
/ba/cars/s60/	/ba/cars/sedan/  *
/ba/cars/s60-hybrid/	/ba/cars/sedan/  *
/co/cars/xc40/	/co/cars/suv  *
/co/cars/xc40/features/	/co/cars/suv  *
/co/cars/xc40/interior-design/	/co/cars/suv  *
/cz/cars/xc40-electric/	/cz/cars/ex40-electric/  *
/cz/cars/xc40-hybrid/features/	/cz/cars/suv/  *
/cz/cars/xc40-hybrid/interior-design/	/cz/cars/suv/  *
/de/cars/c40-electric	/de/cars/ec40-electric/  *
/de/cars/xc40-electric	/de/cars/ex40-electric/  *
/de-ch/cars/c40-electric	/de-ch/cars/ec40-electric/  *
/de-ch/cars/xc40-electric	/de-ch/cars/ex40-electric/  *
/dk/cars/c40-electric	/dk/cars/ec40-electric/  *
/dk/cars/xc40-electric	/dk/cars/ex40-electric/  *
/en-kw/cars/s60-hybrid	/en-kw/cars/sedan/  *
/en-kw/cars/xc60-hybrid	/en-kw/cars/suv/  *
/en-qa/cars/s90-hybrid	/en-qa/cars/sedan/  *
/fi/cars/c40-electric	/fi/cars/ec40-electric/  *
/fi/cars/xc40-electric	/fi/cars/ex40-electric/  *
/fr/cars/xc40-electric	/fr/cars/ex40-electric/  *
/fr-be/cars/c40-electric	/fr-be/cars/ec40-electric/  *
/fr-be/cars/xc40-electric	/fr-be/cars/ex40-electric/  *
/fr-ch/cars/c40-electric	/fr-ch/cars/ec40-electric/  *
/fr-ch/cars/xc40-electric	/fr-ch/cars/ex40-electric/  *
/gr/cars/c40-electric	/gr/cars/ec40-electric/  *
/gr/cars/xc40-electric	/gr/cars/ex40-electric/  *
/hr/cars/s60/	/hr/cars/sedan/  *
/hr/cars/s60/features/	/hr/cars/sedan/  *
/hr/cars/s60/interior-design/	/hr/cars/sedan/  *
/hr/cars/s60-hybrid/	/hr/cars/sedan/  *
/hu/cars/xc40-electric	/hu/cars/ex40-electric/  *
/it/cars/c40-electric	/it/cars/ec40-electric/  *
/it/cars/xc40-electric	/it/cars/ex40-electric/  *
/it-ch/cars/c40-electric	/it-ch/cars/ec40-electric/  *
/it-ch/cars/xc40-electric	/it-ch/cars/ex40-electric/  *
/lu/cars/c40-electric	/lu/cars/ec40-electric/  *
/lu/cars/xc40-electric	/lu/cars/ex40-electric/  *
/me/cars/s60/	/me/cars/sedan/  *
/me/cars/s60-hybrid/	/me/cars/sedan/  *
/mk/cars/s60/	/mk/cars/sedan/  *
/mu/cars/s60/	/mu/cars/sedan/  *
/nl/cars/c40-electric/	/nl/cars/ec40-electric/  *
/nl/cars/xc40-electric/	/nl/cars/ex40-electric/  *
/nl-be/cars/c40-electric/	/nl-be/cars/ec40-electric/  *
/nl-be/cars/xc40-electric/	/nl-be/cars/ex40-electric/  *
/no/cars/c40-electric/	/no/cars/ec40-electric/  *
/no/cars/xc40-electric/	/no/cars/ex40-electric/  *

/si/cars/s60/	/tr/cars/sedan/  *
/si/cars/s60-hybrid/	/tr/cars/sedan/  *
/uk/cars/v60-cross-country/	/uk/cars/wagon/  *
/uk/cars/v90-cross-country/	/uk/cars/wagon/  *
/hu/cars/c40-electric  /hu/cars/ec40-electric/  *
/dk/cars/v90-hybrid/specification  /dk/cars/v90-hybrid/  *
/dk/cars/v60-hybrid/specification  /dk/cars/v60-hybrid/  *
/dk/cars/v90-hybrid/shop  /dk  *
/dk/cars/v60-hybrid/shop  /dk  *
/br/cars/electrification/range  /br/v/cars/electric-cars  *
/se/cars/xc40-electric/specifications  /se/cars/xc40-electric/  *
/se/cars/c40-electric/specifications  /se/cars/c40-electric/  *
/uk/cars/business-sales/business-offers/v60  /uk/cars/v60-hybrid/  *
/uk/cars/business-sales/business-offers/v90  /uk/cars/v90-hybrid/  *
/uk/cars/business-sales/business-offers/s90  /uk/cars/s90-hybrid/  *
/uk/cars/business-sales/business-offers/s60  /uk/cars/s60-hybrid/  *
/uk/cars/business-sales/business-offers/c40-recharge	/uk/cars/c40-electric/  *
/uk/cars/business-sales/business-offers/xc40	/uk/cars/xc40-electric/  *
/uk/cars/business-sales/business-offers/xc90	/uk/cars/xc90-hybrid/  *
/uk/cars/business-sales/business-offers/xc60	/uk/cars/xc60-hybrid/  *

/mx/cars/xc90/  /mx/cars/xc90-hybrid/  *
/mx/cars/xc90/features/  /mx/cars/xc90-hybrid/  *
/mx/cars/xc90/interior-design/  /mx/cars/xc90-hybrid/  *
/mx/cars/xc90/specifications/  /mx/cars/xc90-hybrid/  *
/mx/cars/xc40/  /mx  *
/mx/cars/xc40/features/  /mx  *
/mx/cars/xc40/interior-design/  /mx  *
/mx/cars/xc40/specifications/  /mx  *


/fi/cars/s90-hybrid/specification  /fi/build  *
/fi/cars/xc40-hybrid/specification  /fi/build  *
/at/cars/c40-electric/keep-me-updated-c40-done/  /at/  *
/cz/cars/xc40-hybrid/  /cz/v/cars/plug-in-hybrids  *
# modelos
/cz/cars/xc40-hybrid  /cz/v/cars/plug-in-hybrids  *
/fi/cars/s90-hybrid/specifications  /fi/build  *
/at/cars/xc90-Hybrid/Spezifikation/	/at/cars/xc90-hybrid/specification/  *
/bg/cars/xc60-fuel/	/bg/cars/xc60/  *
/jp/cars/s90-hybrid/shop/	/jp/shop/s90/  *
/sk/cars/xc60-fuel/	/sk/cars/xc60/  *
/en-jo/cars/new-models/v60/specifications/features	/en-jo/  *
/en-jo/cars/new-models/xc40/specifications	/en-jo/cars/suv/  *
/en-jo/cars/new-models/xc40/specifications/features	/en-jo/cars/suv/  *
/en-jo/cars/new-models/xc60/specifications	/en-jo/cars/suv/  *
/en-jo/cars/new-models/xc60/specifications/features	/en-jo/cars/suv/  *
/en-jo/cars/new-models/xc90/specifications	/en-jo/cars/suv/  *
/en-jo/cars/new-models/xc90/specifications/features	/en-jo/cars/suv/  *
/ge/cars/polestar-engineered	/ge/  *
/hr/cars/my24/s90/	/hr/cars/s90/  *
/hr/cars/my24/xc40/	/hr/cars/xc40/  *
/is/cars/xc90-fuel/	/is/cars/xc90/  *
/lb/cars/new-models/s60/specifications	/lb/  *
/lb/cars/new-models/s60/specifications/features	/lb/  *
/lb/cars/new-models/s90/specifications	/lb/  *
/lb/cars/new-models/s90/specifications/features	/lb/  *
/lb/cars/new-models/v60/specifications	/lb/  *
/lb/cars/new-models/v60/specifications/features	/lb/  *
/lb/cars/new-models/xc40/specifications	/lb/cars/suv/  *
/lb/cars/new-models/xc40/specifications/features	/lb/cars/suv/  *
/lb/cars/new-models/xc60/specifications	/lb/cars/suv/  *
/lb/cars/new-models/xc60/specifications/features	/lb/cars/suv/  *
/lb/cars/new-models/xc90/specifications	/lb/cars/suv/  *
/lb/cars/new-models/xc90/specifications/features	/lb/cars/suv/  *
/l-lv/cars/xc90-hybrid/features/	/lv-lv/cars/xc90-hybrid/features/  *
/lu/cars/xs60/	/lu/cars/xc60/  *
/ma/cars/new-models/S60/specifications	/ma/  *
/ma/cars/new-models/S60/specifications/features	/ma/  *
/ma/cars/new-models/xc40/specifications	/ma/cars/xc40/  *
/ma/cars/new-models/xc40/specifications/features	/ma/cars/xc40/features/  *
/ro-md/cars/gama-de-modele/xc40/specifications	/ro-md/cars/xc40/  *
/ro-md/cars/gama-de-modele/xc40/specifications/features	/ro-md/cars/xc40/features/  *
/ro-md/cars/gama-de-modele/xc90/specifications	/ro-md/cars/xc90/  *
/ro-md/cars/gama-de-modele/xc90/specifications/features	/ro-md/cars/xc90/features/  *
/ru-md/cars/new-models/xc40/specifications	/ru-md/cars/xc40/  *
/ru-md/cars/new-models/xc40/specifications/features	/ru-md/cars/xc40/features/  *
/ru-md/cars/new-models/xc90/specifications	/ru-md/cars/xc90/  *
/ru-md/cars/new-models/xc90/specifications/features	/ru-md/cars/xc90/features/  *
/tn/cars/xc90-fuel/	/tn/cars/xc90/  *
/uk/cars/s90-fuel/features/	/uk/cars/s90/features/  *
/uk/cars/s90-fuel/interior-design/	/uk/cars/s90/interior-design/  *
/us/cars/new-models/xc40/accessories	/us/cars/xc40/  *
/us/cars/new-models/xc60/accessories	/us/cars/xc60/  *
/us/cars/new-models/xc60/awards	/us/cars/xc60/  *
/us/cars/new-models/xc60/awards/	/us/cars/xc60/  *
/us/cars/new-models/xc90/accessories	/us/cars/xc90/  *
/br/cars/electromobility/range/	/br/cars/electrification/range/  *
/do/cars/xc60-fuel/	/do/cars/xc60/  *
/en-jo/cars/new-models/s60/specifications	/en-jo/  *
/en-jo/cars/new-models/s60/specifications/features	/en-jo/  *
/en-jo/cars/new-models/s90/specifications	/en-jo/  *
/en-jo/cars/new-models/s90/specifications/features	/en-jo/  *
/en-jo/cars/new-models/v60/specifications	/en-jo/  *
/al/cars/interior-design/	/al/  *
/ar-jo/cars/new-models/s60/specifications	/ar-jo/  *
/ar-jo/cars/new-models/s60/specifications/features	/ar-jo/  *
/ar-jo/cars/new-models/s90/specifications	/ar-jo/  *
/ar-jo/cars/new-models/s90/specifications/features	/ar-jo/  *
/ar-jo/cars/new-models/v60/specifications	/ar-jo/  *
/ar-jo/cars/new-models/v60/specifications/features	/ar-jo/  *
/ar-jo/cars/new-models/xc40/specifications	/ar-jo/cars/suv/  *
/ar-jo/cars/new-models/xc40/specifications/features	/ar-jo/cars/suv/  *
/ar-jo/cars/new-models/xc60/specifications	/ar-jo/cars/suv/  *
/ar-jo/cars/new-models/xc60/specifications/features	/ar-jo/cars/suv/  *
/ar-jo/cars/new-models/xc90/specifications	/ar-jo/cars/suv/  *
/ar-jo/cars/new-models/xc90/specifications/features	/ar-jo/cars/suv/  *
/pt/cars/v60/specification  /pt/  *
/nl/cars/xc40-hybrid  /nl/cars/xc40/  *
/nl-be/cars/xc40-hybrid/specification    /nl-be/cars/xc40-hybrid/  *
/nl/cars/xc60/specification  /nl/cars/xc60-hybrid/specification/  *
/nl/cars/v90/specification  /nl/cars/v90-hybrid/specification/  *
/it/cars/s90/specification  /it/cars/s90/  *
/it/cars/s90-hybrid/specification  /it/cars/s90-hybrid/  *
/us/cars/xc60/specification-my23/  /us/cars/xc60/specification/  *
/it/cars/xc40-hybrid/specification  /it/cars/xc40-hybrid/  *
/en-ca/cars/new-models/my19-xc60-mobile	/en-ca/cars/xc60-hybrid/  *
/en-ca/cars/new-models/s60/accessories	/en-ca/cars/s60/  *
/en-ca/cars/options/offers	/en-ca/l/featured-offers/  *
/en-ca/cars/the-volvo-cars-range	/en-ca/build  *
/fr-ca/cars/new-models/my19-xc60-mobile	/fr-ca/cars/xc60/  *
/fr-ca/cars/new-models/s60/accessories	/fr-ca/cars/s60-hybrid/  *
/fr-ca/cars/options/offers	/fr-ca/l/featured-offers/  *
/fr-ca/cars/the-volvo-cars-range	/fr-ca/build  *
/lu/cars/xc40-hybrid/specification  /lu/cars/xc40-hybrid/  *
/fr-be/cars/xc40-hybrid/specification  /fr-be/cars/xc40-hybrid/  *
/pt/cars/v60-cross-country/specification  /pt/  *
/pt/cars/v90/specification  /pt/  *
/pt/cars/v90-cross-country/specification  /pt/  *
/pt/cars/xc60/specification  /pt/  *
/pt/cars/s90-hybrid/specification  /pt/  *
/pt/cars/s90/specification  /pt/  *

/uk/cars/s60-hybrid/specification  /uk/cars/s60-hybrid/  *
/uk/cars/v60-hybrid/specification /uk/cars/v60-hybrid/  *
/uk/cars/v60/specification  /uk/cars/v60/  *
/uk/cars/v90-hybrid/specification  /uk/cars/v90-hybrid/  *
/uk/cars/v90/specification  /uk/cars/v90/  *

/uk-ua/cars/fleet-sales/business-driver	/uk/business/  *
/uk-ua/cars/fleet-sales/fleet-manager	/uk/business/  *
/uk-ua/cars/fleet-sales	/uk/business/  *
/uk-ua/cars/fleet-sales/meet-the-team	/uk/business/  *
/uk/cars/business-sales/affinity/05gzp1	/uk/business/  *
/uk/cars/business-sales/affinity/0ynp3x	/uk/business/  *
/uk/cars/business-sales/affinity/1eb5vx	/uk/business/  *
/uk/cars/business-sales/affinity/33ta2u	/uk/business/  *
/uk/cars/business-sales/affinity/3wcb7t	/uk/business/  *
/uk/cars/business-sales/affinity/7tb6km	/uk/business/  *
/uk/cars/business-sales/affinity/8d5b1s	/uk/business/  *
/uk/cars/business-sales/affinity/8srgrz	/uk/business/  *
/uk/cars/business-sales/affinity/90hwg4	/uk/business/  *
/uk/cars/business-sales/affinity/btfjp3	/uk/business/  *
/uk/cars/business-sales/affinity/h26ezy	/uk/business/  *
/uk/cars/business-sales/affinity/hjmjxz	/uk/business/  *
/uk/cars/business-sales/affinity/lm92vh	/uk/business/  *
/uk/cars/business-sales/affinity/p8vtx2	/uk/business/  *
/uk/cars/business-sales/affinity/the-volvo-affinity-partner-programme	/uk/business/  *
/uk/cars/business-sales/affinity/xw39qz	/uk/business/  *
/uk/cars/business-sales/affinity/zs082r	/uk/business/  *
/uk/cars/business-sales/business-offers/xc40recharge	/uk/business/  *
/uk/cars/business-sales/business-tools/car-comparison-tool	/uk/business/  *
/uk/cars/business-sales/business-tools	/uk/business/  *
/uk/cars/business-sales/business-tools/tco	/uk/business/  *
/uk/cars/business-sales/call-back	/uk/business/  *
/uk/cars/business-sales/company-car	/uk/business/  *
/uk/cars/business-sales/events	/uk/business/  *
/uk/cars/business-sales/events/vehicles-on-stand	/uk/business/  *
/uk/cars/business-sales/hybrid-for-business	/uk/business/  *
/uk/cars/business-sales/hybridfleet	/uk/business/  *
/uk/cars/business-sales	/uk/business/  *
/uk/cars/business-sales/leasing	/uk/business/  *
/uk/cars/business-sales/vq	/uk/business/  *
/uk/cars/business-sales/vq/subscribe-to-vq	/uk/business/  *
/uk/cars/eden-project	/uk/shop/  *
/uk/cars/eden-project/terms	/uk/shop/  *
/uk/cars/model-lineup	/uk/shop/  *
/uk/cars/new-models/ninety	/uk/shop/  *
/uk/cars/new-models/ninety/r-design	/uk/shop/  *
/uk/cars/new-models/s60/accessories	/uk/cars/s60-hybrid/  *
/uk/cars/new-models/s60/offers/business	/uk/cars/s60-hybrid/  *
/uk/cars/new-models/s60/reviews	/uk/cars/s60-hybrid/  *
/uk/cars/new-models/s60/test-drive	/uk/cars/s60-hybrid/  *
/uk/cars/new-models/s60/variants	/uk/cars/s60-hybrid/  *
/uk/cars/new-models/s60/variants/inscription	/uk/cars/s60-hybrid/  *
/uk/cars/new-models/s60/variants/polestar	/uk/cars/s60-hybrid/  *
/uk/cars/new-models/s60/variants/r-design	/uk/cars/s60-hybrid/  *
/uk/cars/new-models/s90/accessories	/uk/v/cars/sedan/  *
/uk/cars/new-models/s90/business-magazine	/uk/v/cars/sedan/  *
/uk/cars/new-models/s90/offers/business	/uk/v/cars/sedan/  *
/uk/cars/new-models/s90/offers/personal	/uk/v/cars/sedan/  *
/uk/cars/new-models/s90/personal-magazine	/uk/v/cars/sedan/  *
/uk/cars/new-models/s90/r-design	/uk/v/cars/sedan/  *
/uk/cars/new-models/s90/test-drive	/uk/v/cars/sedan/  *
/uk/cars/new-models/s90/the-guide	/uk/v/cars/sedan/  *
/uk/cars/new-models/s90/variants	/uk/v/cars/sedan/  *
/uk/cars/new-models/s90/variants/inscription	/uk/v/cars/sedan/  *
/uk/cars/new-models/s90/variants/momentum	/uk/v/cars/sedan/  *
/uk/cars/new-models/s90/variants/r-design	/uk/v/cars/sedan/  *
/uk/cars/new-models/s90/volvos90	/uk/v/cars/sedan/  *
/uk/cars/new-models/v40	/uk/cars/v60/  *
/uk/cars/new-models/v60/accessories	/uk/cars/v60/  *
/uk/cars/new-models/v60/loyalty-offer-request	/uk/cars/v60/  *
/uk/cars/new-models/v60/offers/business	/uk/cars/v60/  *
/uk/cars/new-models/v60/reviews-classic/ask-an-owner	/uk/cars/v60/  *
/uk/cars/new-models/v60/reviews-classic	/uk/cars/v60/  *
/uk/cars/new-models/v60/test-drive	/uk/cars/v60/  *
/uk/cars/new-models/v60/v60-loyalty-offer	/uk/cars/v60/  *
/uk/cars/new-models/v60/variants/cross-country	/uk/cars/v60/  *
/uk/cars/new-models/v60/variants	/uk/cars/v60/  *
/uk/cars/new-models/v60/variants/inscription	/uk/cars/v60/  *
/uk/cars/new-models/v60/variants/momentum	/uk/cars/v60/  *
/uk/cars/new-models/v60/variants/polestar-engineered	/uk/cars/v60/  *
/uk/cars/new-models/v60/variants/r-design	/uk/cars/v60/  *
/uk/cars/new-models/v60/volvov60	/uk/cars/v60/  *
/uk/cars/new-models/v90/accessories	/uk/cars/v90/  *
/uk/cars/new-models/v90/offers/business	/uk/cars/v90/  *
/uk/cars/new-models/v90/test-drive	/uk/cars/v90/  *
/uk/cars/new-models/v90/variants/cross-country	/uk/cars/v90/  *
/uk/cars/new-models/v90/variants	/uk/cars/v90/  *
/uk/cars/new-models/v90/variants/inscription	/uk/cars/v90/  *
/uk/cars/new-models/v90/variants/momentum	/uk/cars/v90/  *
/uk/cars/new-models/v90/variants/r-design	/uk/cars/v90/  *
/uk/cars/new-models/v90/variants/volvo-ocean-race	/uk/cars/v90/  *
/uk/cars/new-models/v90/volvov90	/uk/cars/v90/  *
/uk/cars/new-models/xc40/offers/business	/uk/cars/xc40/  *
/uk/cars/new-models/xc40/offers/motability	/uk/cars/xc40/  *
/uk/cars/new-models/xc40/pure-electric-request	/uk/cars/xc40/  *
/uk/cars/new-models/xc40/test-drive	/uk/cars/xc40/  *
/uk/cars/new-models/xc40/volvoxc40	/uk/cars/xc40/  *
/uk/cars/new-models/xc60/accessories	/uk/cars/xc60/  *
/uk/cars/new-models/xc60/family-campaign/thank-you	/uk/cars/xc60/  *
/uk/cars/new-models/xc60/hybrid/test-drive	/uk/cars/xc60/  *
/uk/cars/new-models/xc60/offers/business	/uk/cars/xc60/  *
/uk/cars/new-models/xc60/test-drive	/uk/cars/xc60/  *
/uk/cars/new-models/xc60/variants	/uk/cars/xc60/  *
/uk/cars/new-models/xc60/variants/inscription	/uk/cars/xc60/  *
/uk/cars/new-models/xc60/variants/momentum	/uk/cars/xc60/  *
/uk/cars/new-models/xc60/variants/r-design	/uk/cars/xc60/  *
/uk/cars/new-models/xc60/variants/twin-engine	/uk/cars/xc60/  *
/uk/cars/new-models/xc60/volvoxc60	/uk/cars/xc60/  *
/uk/cars/new-models/xc60/xc60-loyalty-offer	/uk/cars/xc60/  *
/uk/cars/new-models/xc90/accessories	/uk/cars/xc90/  *
/uk/cars/new-models/xc90/competition/thank-you	/uk/cars/xc90/  *
/uk/cars/new-models/xc90/loyalty-offer-request	/uk/cars/xc90/  *
/uk/cars/new-models/xc90/offers/business	/uk/cars/xc90/  *
/uk/cars/new-models/xc90/test-drive	/uk/cars/xc90/  *
/uk/cars/new-models/xc90/variants	/uk/cars/xc90/  *
/uk/cars/new-models/xc90/variants/inscription	/uk/cars/xc90/  *
/uk/cars/new-models/xc90/variants/momentum	/uk/cars/xc90/  *
/uk/cars/new-models/xc90/variants/r-design	/uk/cars/xc90/  *
/uk/cars/new-models/xc90/variants/twin-engine	/uk/cars/xc90/  *
/uk/cars/new-models/xc90/volvoxc90	/uk/cars/xc90/  *
/uk/cars/new-models/xc90/xc90-loyalty-offer	/uk/cars/xc90/  *
/uk/cars/offers/motability	/uk/l/offers/  *
/uk/cars/options/offers	/uk/l/offers/  *
/uk/cars/polestar	/uk/  *
/uk/cars/polestar/polestar-faq	/uk/  *
/uk/cars/polestar/polestar-out-of-stock-page	/uk/  *
/uk/cars/polestar/polestar-payment-error-page	/uk/  *
/uk/cars/polestar/polestar-technical-error-page	/uk/  *
/uk/cars/polestar/polestar-version-out-of-stock	/uk/  *
/uk/cars/used-cars/checked-and-updated	/uk/l/used-cars/  *
/uk/cars/used-cars/exchange-guarantee	/uk/l/used-cars/  *
/uk/cars/used-cars/volvo-assistance	/uk/l/used-cars/  *
/uk/cars/used-cars/warranty-and-mot	/uk/l/used-cars/  *

##Expiry 2023-04-01
/dk/cars/xc40-hybrid/specification/  /dk/cars/xc40-hybrid/  *
/es/cars/xc40-pure-electric-form  /es/keep-me-updated  *
/es/modelos/campanas-y-ofertas/formulario-dct-oferta-v40-cross-country	/es/l/coches/ofertas-promociones/	*
/es/modelos/campanas-y-ofertas/formulario-dct-oferta-v40-r-design	/es/l/coches/ofertas-promociones/	*
/es/modelos/campanas-y-ofertas/formulario-wffs-oferta-v40	/es/l/coches/ofertas-promociones/	*
/es/modelos/campanas-y-ofertas/oferta-s60-premium-edition	/es/cars/s60/	*
/es/modelos/campanas-y-ofertas/oferta-v40	/es/l/coches/ofertas-promociones/	*
/es/modelos/campanas-y-ofertas/oferta-v40-cross-country-edicion-especial	/es/l/coches/ofertas-promociones/	*
/es/modelos/campanas-y-ofertas/oferta-v40-r-design	/es/l/coches/ofertas-promociones/	*
/es/modelos/campanas-y-ofertas/oferta-v60-cross-country	/es/cars/v60-cross-country/	*
/es/modelos/campanas-y-ofertas/oferta-v60-premium-edition	/es/cars/v60/	*
/es/modelos/campanas-y-ofertas/oferta-xc60-	/es/l/coches/ofertas-promociones/	*
/es/modelos/campanas-y-ofertas/oferta-xc60-premium-edition	/es/l/coches/ofertas-promociones/	*
/es/modelos/campanas-y-ofertas/v40-cuota	/es/l/coches/ofertas-promociones/	*
/es/modelos/concept-cars	/es/v/car-safety/eva-initiative-cars-equally-safe	*
/es/modelos/concept-cars/concept-coupe	/es/v/cars/concept-models/concept-coupe	*
/es/modelos/concept-cars/concept-estate	/es/v/cars/concept-models/concept-estate	*
/es/modelos/concept-cars/concept-xc-coupe	/es/v/cars/concept-models/concept-xc-coupe	*
/es/modelos/futureofdriving	/es/v/our-story/	*
/es/modelos/nuevos-modelos-volvo/nuevo-s90	/es/cars/s90/	*
/es/modelos/nuevos-modelos-volvo/nuevo-s90/accesorios	/es/v/buy/accessories	*
/es/modelos/nuevos-modelos-volvo/nuevo-s90/especificaciones	/es/cars/s90/	*
/es/modelos/nuevos-modelos-volvo/nuevo-s90/formularios-s90	/es/cars/s90/	*
/es/modelos/nuevos-modelos-volvo/nuevo-s90/producto	/es/cars/s90/	*
/es/modelos/nuevos-modelos-volvo/nuevo-s90/r-design	/es/cars/s90/	*
/es/modelos/nuevos-modelos-volvo/nuevo-v90	/es/cars/v90/	*
/es/modelos/nuevos-modelos-volvo/nuevo-v90/accesorios  /es/v/buy/accessories	*
/es/modelos/nuevos-modelos-volvo/nuevo-v90/especificaciones	/es/cars/v90/	*
/es/modelos/nuevos-modelos-volvo/nuevo-v90/formularios-v90	/es/cars/v90/	*
/es/modelos/nuevos-modelos-volvo/nuevo-v90/mas-informacion	/es/cars/v90/	*
/es/modelos/nuevos-modelos-volvo/nuevo-v90/producto	/es/cars/v90/	*
/es/modelos/nuevos-modelos-volvo/nuevo-v90/r-design	/es/cars/v90/  *
/es/modelos/nuevos-modelos-volvo/nuevo-xc90	/es/cars/xc90/	*
/es/modelos/nuevos-modelos-volvo/s60	/es/cars/s60/	*
/es/modelos/nuevos-modelos-volvo/s60-cross-country	/es/cars/s60/	*
/es/modelos/nuevos-modelos-volvo/s60/accesorios	/es/v/buy/accessories	*
/es/modelos/nuevos-modelos-volvo/s60/accessorios	/es/v/buy/accessories	*
/es/modelos/nuevos-modelos-volvo/s60/especificaciones	/es/cars/s60/	*
/es/modelos/nuevos-modelos-volvo/s60/especificaciones-y-producto	/es/cars/s60/	*
/es/modelos/nuevos-modelos-volvo/s60/pruebas-de-coches-s60	/es/cars/s60/	*
/es/modelos/nuevos-modelos-volvo/v40	/es/v/cars/wagon	*
/es/modelos/nuevos-modelos-volvo/v40-cross-country	/es/v/cars/wagon	*
/es/modelos/nuevos-modelos-volvo/v40-cross-country/accesorios	/es/v/cars/wagon	*
/es/modelos/nuevos-modelos-volvo/v40-cross-country/especificaciones	/es/v/cars/wagon	*
/es/modelos/nuevos-modelos-volvo/v40-cross-country/especificaciones-y-producto	/es/v/cars/wagon	*
/es/modelos/nuevos-modelos-volvo/v40-cross-country/formularios-v40-cross-country	/es/v/cars/wagon	*
/es/modelos/nuevos-modelos-volvo/v40-cross-country/galeria	/es/v/cars/wagon	*
/es/modelos/nuevos-modelos-volvo/v40-cross-country/producto	/es/v/cars/wagon	*
/es/modelos/nuevos-modelos-volvo/v40/accesorios	/es/v/cars/wagon	*
/es/modelos/nuevos-modelos-volvo/v40/especificaciones	/es/v/cars/wagon	*
/es/modelos/nuevos-modelos-volvo/v40/formularios-v40	/es/v/cars/wagon	*
/es/modelos/nuevos-modelos-volvo/v40/galeria	/es/v/cars/wagon	*
/es/modelos/nuevos-modelos-volvo/v40/producto	/es/v/cars/wagon	*
/es/modelos/nuevos-modelos-volvo/v40/versiones	/es/v/cars/wagon	*
/es/modelos/nuevos-modelos-volvo/v60	/es/cars/v60/	*
/es/modelos/nuevos-modelos-volvo/v60/accesorios	/es/v/buy/accessories	*
/es/modelos/nuevos-modelos-volvo/v60/especificaciones	/es/cars/v60/	*
/es/modelos/nuevos-modelos-volvo/v60/especificaciones-y-producto	/es/cars/v60/	*
/es/modelos/nuevos-modelos-volvo/v60/formularios-v60  /es/cars/v60/  *
/es/modelos/nuevos-modelos-volvo/v60/polestar	/es/cars/v60/	*
/es/modelos/nuevos-modelos-volvo/v60/producto	/es/cars/v60/	*
/es/modelos/nuevos-modelos-volvo/v60/v60-hibrido	/es/cars/v60-hybrid/	*
/es/modelos/nuevos-modelos-volvo/v60/versiones	/es/cars/v60/	*
/es/modelos/nuevos-modelos-volvo/v90-cross-country	/es/cars/v90-cross-country/	*
/es/modelos/nuevos-modelos-volvo/v90-cross-country/Item-924BB3E5-F6CE-44FD-9D68-CDA045AA729C	/es/cars/v90/	*
/es/modelos/nuevos-modelos-volvo/v90-cross-country/Item-C31447B0-6618-450F-A86E-7B99669F8DA1	/es/cars/v90/	*
/es/modelos/nuevos-modelos-volvo/v90-cross-country/accesorios	/es/cars/v90-cross-country/	*
/es/modelos/nuevos-modelos-volvo/v90-cross-country/e-catalogo	/es/cars/v90-cross-country/	*
/es/modelos/nuevos-modelos-volvo/v90-cross-country/especificaciones	/es/cars/v90-cross-country/	*
/es/modelos/nuevos-modelos-volvo/v90-cross-country/formularios-v40-cross-country	/es/cars/v90-cross-country/	*
/es/modelos/nuevos-modelos-volvo/v90-cross-country/formularios-v90-cross-country	/es/cars/v90-cross-country/	*
/es/modelos/nuevos-modelos-volvo/v90-cross-country/libertad-de-explorar	/es/cars/v90-cross-country/	*
/es/modelos/nuevos-modelos-volvo/v90-cross-country/mas-informacion	/es/cars/v90-cross-country/	*
/es/modelos/nuevos-modelos-volvo/xc60	/es/cars/xc60/	*
/es/modelos/nuevos-modelos-volvo/xc60/formularios-xc60	/es/cars/xc60/	*
/es/modelos/nuevos-modelos-volvo/xc60/te-hara-sentir/movimiento	/es/cars/xc60/	*
/es/modelos/nuevos-modelos-volvo/xc90	/es/cars/xc90/	*
/es/modelos/nuevos-modelos-volvo/xc90/accessorios	/es/v/buy/accessories	*
/es/modelos/nuevos-modelos-volvo/xc90/especificaciones	/es/cars/xc90/	*
/es/modelos/nuevos-modelos-volvo/xc90/formularios-xc90	/es/cars/xc90/	*
/es/modelos/nuevos-modelos-volvo/xc90/precios	/es/cars/xc90/	*
/es/modelos/nuevos-modelos-volvo/xc90/versiones	/es/cars/xc90/	*
/es/modelos/nuevos-modelos-volvo/xc90/xc90-hibrido-enchufable	/es/cars/xc90-hybrid/	*
/es/modelos/todos-los-modelos	/es/l/coches/precios/	*
/es/modelos/volvo-selekt	/es/l/coches/segunda-mano-ocasion/	*

#all-cars redirects
/es/mobile/all-cars/all-new-volvo-xc90	/es/cars/xc90/	*
/es/mobile/all-cars/volvo-s60	/es/cars/s60/	*
/es/mobile/all-cars/volvo-v40	/es/v/cars/wagon	*
/es/mobile/all-cars/volvo-v40-cross-country	/es/v/cars/wagon	*
/es/mobile/all-cars/volvo-v40-cross-country/which/pages	/es/v/cars/wagon	*
/es/mobile/all-cars/volvo-v60	/es/cars/v60/	*
/es/mobile/all-cars/volvo-v60/which/pages	/es/cars/v60/	*
/es/mobile/all-cars/volvo-xc60	/es/cars/xc60/	*

#Specifications redirections
##Expiry 2023-10-01
/uk/cars/business-sales/affinity/4n6f2q/offers  /uk/business/  *
/uk/cars/business-sales/affinity/partner  /uk/business/  *
/uk/cars/business-sales/fleet-hub  /uk/business/fleet  *
/uk/cars/business-sales/fleet-hub/factsheets/xc90-t8-twin-engine  /uk/business/  *
/uk/cars/business-sales/homecharger  /uk/business/  *


/nl/cars/s90  /nl/cars/s90-hybrid/  *
/nl/cars/v90  /nl/cars/v90-hybrid/  *
/nl/cars/xc60  /nl/cars/xc60-hybrid/  *
##Expiry 2023-05-30
/fi/cars/xc40/  /fi/v/cars/suv  *
/fi/cars/xc60/  /fi/v/cars/suv  *
/fi/cars/xc90/  /fi/v/cars/suv  *
/fi/cars/s90/   /fi/v/cars/sedan  *
/fi/cars/v60/  /fi/v/cars/wagon  *
/fi/cars/v60-cross-country/  /fi/v/cars/wagon  *
/fi/cars/v90/  /fi/v/cars/wagon  *
/fi/cars/v90-cross-country/  /fi/v/cars/wagon  *
##Expiry 2023-04-01
/no/cars/options/offers	/no/l/cars/options/offers/  *
/au/cars/polestar/optimised	/au  *
##Expiry 2023-04-15
/zh-cn/cars/new-models/c40-recharge/specifications/  /zh-cn/l/specifications/c40-recharge/  *
/zh-cn/cars/new-models/xc40-recharge/specifications/  /zh-cn/l/specifications/xc40-recharge/  *
/zh-cn/cars/new-models/xc90-recharge-t8/specifications  /zh-cn/l/specifications/xc90-recharge/  *
/zh-cn/cars/new-models/all-new-xc90/specifications/  /zh-cn/l/specifications/xc90/  *
/zh-cn/cars/new-models/xc60-recharge-t8/specifications1/  /zh-cn/l/specifications/xc60-recharge/  *
/zh-cn/cars/new-models/the-new-xc60/specifications1/  /zh-cn/l/specifications/xc60/  *
/zh-cn/cars/new-models/xc40/specifications2  /zh-cn/l/specifications/xc40/  *
/zh-cn/cars/new-models/s90-recharge-t8/specifications/  /zh-cn/l/specifications/s90-recharge/  *
/zh-cn/cars/new-models/s90/specifications/  /zh-cn/l/specifications/s90/  *
/zh-cn/cars/new-models/s60-recharge-t8/specifications/  /zh-cn/l/specifications/s60-recharge/  *
/zh-cn/cars/new-models/s60/specifications/  /zh-cn/l/specifications/s60/  *
/zh-cn/cars/new-models/v90-cross-country/specifications  /zh-cn/l/specifications/v90cc/  *
/zh-cn/cars/new-models/v60/specifications1/  /zh-cn/l/specifications/v60/  *
/ro/cars/masini-electrice/plug-in-hybrids  /ro/v/cars/plug-in-hybrids  *
/ro/cars/new-models/s60/specifications/dimensions  /ro/cars/s60/  *
/ro/cars/new-models/s60/specifications/engines  /ro/cars/s60/  *
/ro/cars/new-models/s60/specifications/features  /ro/cars/s60/  *
/ro/cars/new-models/s60/specifications  /ro/cars/s60/  *
/ro/cars/new-models/s60/specifications/trims-comparison  /ro/cars/s60/  *
/ro/cars/new-models/s90/specifications/dimensions  /ro/cars/s90/  *
/ro/cars/new-models/s90/specifications/engines  /ro/cars/s90/  *
/ro/cars/new-models/s90/specifications/features  /ro/cars/s90  *
/ro/cars/new-models/s90/specifications	/ro/cars/s90/  *
/ro/cars/new-models/s90/specifications/trims-comparison	 /ro/cars/s90/  *
/ro/cars/new-models/v60/specifications/dimensions	/ro/cars/v60/  *
/ro/cars/new-models/v60/specifications/engines	/ro/cars/v60/  *
/ro/cars/new-models/v60/specifications/features	/ro/cars/v60/  *
/ro/cars/new-models/v60/specifications	/ro/cars/v60/  *
/ro/cars/new-models/v60/specifications/trims-comparison	/ro/cars/v60/  *
/ro/cars/new-models/v90cc/specifications/dimensions	/ro/cars/v90-cross-country/  *
/ro/cars/new-models/v90cc/specifications/engines	/ro/cars/v90-cross-country/  *
/ro/cars/new-models/v90cc/specifications/features  /ro/cars/v90-cross-country/  *
/ro/cars/new-models/v90cc/specifications  /ro/cars/v90-cross-country/  *
/ro/cars/new-models/v90cc/specifications/trims-comparison	/ro/cars/v90-cross-country/  *
/ro/cars/new-models/xc40/specificatii/compara-echiparile  /ro/cars/xc40/  *
/ro/cars/new-models/xc40/specificatii/functionalitati	/ro/cars/xc40/  *
/ro/cars/new-models/xc40/specificatii	/ro/cars/xc40/  *
/ro/cars/new-models/xc40/specificatii/motorizari	/ro/cars/xc40/  *
/ro/cars/new-models/xc60/specificatii/compara-echiparile	/ro/cars/xc60/  *
/ro/cars/new-models/xc60/specificatii/dimensiuni	/ro/cars/xc60/  *
/ro/cars/new-models/xc60/specificatii/functionalitati	/ro/cars/xc60/  *
/ro/cars/new-models/xc60/specificatii	/ro/cars/xc60/  *
/ro/cars/new-models/xc60/specificatii/motorizari	/ro/cars/xc60/  *
/ro/cars/new-models/xc90/specifications/dimensions	/ro/cars/xc90/  *
/ro/cars/new-models/xc90/specifications/engines	 /ro/cars/xc90/  *
/ro/cars/new-models/xc90/specifications/features	/ro/cars/xc90/  *
/ro/cars/new-models/xc90/specifications	 /ro/cars/xc90/  *
/ro/cars/new-models/xc90/specifications/trim-comparison	 /ro/cars/xc90/  *
/en-ae/cars/new-models/v90cc/specifications		/en-ae		 *					
/en-ae/cars/new-models/v90cc/specifications/dimensions		/en-ae *							
/en-ae/cars/new-models/v90cc/specifications/engines		/en-ae	 *						
/en-ae/cars/new-models/v90cc/specifications/features		/en-ae	 *						
/en-ae/cars/new-models/v90cc/specifications/trims-comparison		/en-ae *		
##Expiry 2023-04-01
/tw/cars/new-models/xc40/spdownload  https://www.volvocartw.com/pdf/carsp/XC40.pdf  *
/zh-cn/cars/new-models/c40-recharge/gpss/  /zh-cn/l/gpss/c40-recharge/  *
/zh-cn/cars/new-models/xc40-recharge/gpss  /zh-cn/l/gpss/xc40-recharge/  *
/zh-cn/cars/new-models/all-new-xc90/gpss  /zh-cn/l/gpss/xc90/  *
/zh-cn/cars/new-models/xc90-recharge-t8/gpss  /zh-cn/l/gpss/xc90-recharge/  *
/zh-cn/cars/new-models/the-new-xc60/gpss  /zh-cn/l/gpss/xc60/  *
/zh-cn/cars/new-models/xc60-recharge-t8/gpss/  /zh-cn/l/gpss/xc60-recharge/  *
/zh-cn/cars/new-models/xc40/gpss  /zh-cn/l/gpss/xc40/  *
/zh-cn/cars/new-models/s90/gpss  /zh-cn/l/gpss/s90/  *
/zh-cn/cars/new-models/s90-recharge-t8/gpss  /zh-cn/l/gpss/s90-recharge/  *
/zh-cn/cars/new-models/s60/gpss  /zh-cn/l/gpss/s60/  *
/zh-cn/cars/new-models/s60-recharge-t8/gpss/  /zh-cn/l/gpss/s60-recharge/  *
/zh-cn/cars/new-models/v90-cross-country/gpss  /zh-cn/l/gpss/v90cc/  *
/zh-cn/cars/new-models/v60/gpss  /zh-cn/l/gpss/v60/  *
##Expiry 2023-06-15
/us/cars/undefined  /us/v/cars/electric-cars  *
##Expiry 2023-02-15
/dk/cars/privatleasing   /dk/l/leasing/privatleasing/  *

##Expiry 2023-01-30
/se/cars/xc40-hybrid/  /se/l/slutsald-xc40/  *
##Expiry 2023-03-30
/uk/cars/business-sales/business-offers  /uk/l/offers/business/  *
##Expiry 2023-03-25
/uk/cars/new-models/xc90/offers/personal  /uk/l/offers/xc90/  *
##Expiry 2023-04-18
/dk/cars/new-models/xc40/specifications/dimensions		/dk/cars/xc40-hybrid/  *						
/dk/cars/new-models/xc40/specifications/engines		/dk/cars/xc40-hybrid/  *							
/dk/cars/new-models/xc40/specifications/features		/dk/cars/xc40-hybrid/	 *						
/dk/cars/new-models/xc40/specifications		/dk/cars/xc40-hybrid/	 *						
/dk/cars/new-models/xc40/specifications/trims-comparison		/dk/cars/xc40-hybrid/  *	
/gr/cars/new-models/xc40/specifications/engines		/gr/cars/xc40/specification/	 *						
/gr/cars/new-models/xc40/specifications/features		/gr/cars/xc40/specification/	 *						
/gr/cars/new-models/xc40/specifications		/gr/cars/xc40/specification/		 *	
##Expiry 2023-03-15
/zh-cn/cars/new-models/xc40-recharge/financing-offers  /zh-cn/l/financing-offers/xc40-recharge/  *
/zh-cn/cars/new-models/xc60-recharge-t8/financing-offers  /zh-cn/l/financing-offers/xc60-recharge/  *
/zh-cn/cars/new-models/the-new-xc60/financing-offers  /zh-cn/l/financing-offers/xc60/  *
/zh-cn/cars/new-models/s90-recharge-t8/financing-offers  /zh-cn/l/financing-offers/s90-recharge/  *
/zh-cn/cars/new-models/s90/financing-offers  /zh-cn/l/financing-offers/s90/  *
/zh-cn/cars/new-models/s90/financing-offers/  /zh-cn/l/financing-offers/s90/  *
/zh-cn/cars/new-models/s60-recharge-t8/financing-offers  /zh-cn/l/financing-offers/s60-recharge/  *
/zh-cn/cars/new-models/s60/financing-offers   /zh-cn/l/financing-offers/s60/  *
/zh-cn/cars/new-models/xc40/financing-offers  /zh-cn/l/financing-offers/xc40/  *
/zh-cn/cars/new-models/v60/financing-offers  /zh-cn/l/financing-offers/v60/  *
/zh-cn/cars/new-models/c40-recharge/financing-offers/  /zh-cn/l/financing-offers/c40-recharge/  *
/zh-cn/cars/new-models/xc40-recharge/financing-offers/  /zh-cn/l/financing-offers/xc40-recharge/  *
/zh-cn/cars/new-models/xc90-recharge-t8/financing-offers  /zh-cn/l/financing-offers/xc90-recharge/  *
/zh-cn/cars/new-models/all-new-xc90/financing-offers  /zh-cn/l/financing-offers/xc90/  *
/zh-cn/cars/new-models/xc60-recharge-t8/financing-offers/  /zh-cn/l/financing-offers/xc60-recharge/  *
/zh-cn/cars/new-models/the-new-xc60/financing-offers/  /zh-cn/l/financing-offers/xc60/  *
/zh-cn/cars/new-models/s90-recharge-t8/financing-offers/  /zh-cn/l/financing-offers/s90-recharge/  *
/zh-cn/cars/new-models/s60-recharge-t8/financing-offers/   /zh-cn/l/financing-offers/s60-recharge/  *
/zh-cn/cars/new-models/s60/financing-offers/  /zh-cn/l/financing-offers/s60/  *
/zh-cn/cars/new-models/xc40/financing-offers/  /zh-cn/l/financing-offers/xc40/  *
/zh-cn/cars/new-models/v90-cross-country/financing-offers  /zh-cn/l/financing-offers/v90cc/  *
/zh-cn/cars/new-models/v60/financing-offers/  /zh-cn/l/financing-offers/v60/  *
##Expiry 2023-04-15
/fi/cars/s60/  /fi/v/cars/sedan  *
/fi/cars/s60/interior-design/  /fi/v/cars/sedan  *
/fi/cars/s60/features/  /fi/v/cars/sedan  *
##Expiry 2023-04-04
/ie/cars/electric-cars/plug-in-hybrids  /ie/v/cars/plug-in-hybrids  *
/ie/cars/new-models/c40  /ie/cars/c40-electric  *
##Expiry 2023-01-30
/tw/cars/volvo-selekt  http://www.volvoselekt.com.tw/  *

##Expiry 2023-04-25
/en-qa/cars/concept-cars	/en-qa/v/cars/concept-models  *
/en-qa/cars/concept-cars/360c	/en-qa/v/cars/concept-models/360c	  *
/en-qa/cars/concept-cars/ambience-interior	/en-qa/v/cars/concept-models/ambience  *
/en-qa/cars/concept-cars/concept-40	/en-qa/v/cars/concept-models/concept-40  *
/en-qa/cars/concept-cars/concept-coupe	/en-qa/v/cars/concept-models/concept-coupe  *
/en-qa/cars/concept-cars/concept-estate  /en-qa/v/cars/concept-models/concept-estate  *
/en-qa/cars/concept-cars/concept-xc-coupe  /en-qa/v/cars/concept-models/concept-xc-coupe  *
/kr/cars/new-models/the-new-volvo-c40-recharge/specifications  /kr/cars/c40-electric/specification/  *
/kr/cars/new-models/the-new-volvo-xc40-last/specifications  /kr/cars/xc40-electric/specification/  *
##Expiry 2023-06-15
/es/xc40-electrico/  /es/cars/xc40-electric/  *
##expiry 2023-01-30
/my/cars/new-models/s90/specifications/dimensions  /my  *
/my/cars/new-models/s90/specifications/engines  /my  *
/my/cars/new-models/s90/specifications/features  /my  *
/my/cars/new-models/s90/specifications  /my  *
/my/cars/new-models/s90/specifications/trim-comparison  /my  *
/en-th/cars/new-models/the-new-s90-my20/specifications		/en-th	 *						
/en-th/cars/new-models/the-new-s90-my20/specifications/dimensions		/en-th	 *						
/en-th/cars/new-models/the-new-s90-my20/specifications/engines		/en-th	 *						
/en-th/cars/new-models/the-new-s90-my20/specifications/features		/en-th	 *						
/en-th/cars/new-models/the-new-s90-my20/specifications/trims-comparison		/en-th	 *						
/en-th/cars/new-models/xc40-my20/specifications		/en-th *					
/en-th/cars/new-models/xc60-my20/specifications		/en-th *							
/en-th/cars/new-models/xc90-my20/specifications		/en-th *							
/en-th/cars/new-models/xc90-my20/specifications/dimensions		/en-th  *							
/en-th/cars/new-models/xc90-my20/specifications/engines		/en-th	 *						
/en-th/cars/new-models/xc90-my20/specifications/features		/en-th  *							
/en-th/cars/new-models/xc90-my20/specifications/trims-comparison		/en-th		 *					
/th-th/cars/new-models/s60-my20/specifications		/th-th	 *						
/th-th/cars/new-models/the-new-s90-my20/specifications		/th-th		 *					
/th-th/cars/new-models/xc40-my20/specifications		/th-th	 *						
/th-th/cars/new-models/xc60-my20/specifications		/th-th	 *						
/th-th/cars/new-models/xc90-my20/specifications		/th-th	 *
# Specific redirections
##Expiry 2023-04-15

/uk/cars/new-models/s60/specifications/dimensions		/uk/cars/s60/		 *					
/uk/cars/new-models/s60/specifications/engines		/uk/cars/s60/	 *						
/uk/cars/new-models/s60/specifications/features		/uk/cars/s60/	 *						
/uk/cars/new-models/s60/specifications		/uk/cars/s60/	 *						
/uk/cars/new-models/s60/specifications/trims-comparison		/uk/cars/s60/	 *						
/uk/cars/new-models/v60/specifications/dimensions		/uk/cars/v60/	 *						
/uk/cars/new-models/v60/specifications/engines		/uk/cars/v60/	 *						
/uk/cars/new-models/v60/specifications/features		/uk/cars/v60/	 *						
/uk/cars/new-models/v60/specifications		/uk/cars/v60/		 *					
/uk/cars/new-models/v60/specifications/trims-comparison		/uk/cars/v60/	 *						
/uk/cars/new-models/v90/specifications/dimensions		/uk/cars/v90/	 *						
/uk/cars/new-models/v90/specifications/engines		/uk/cars/v90/ *							
/uk/cars/new-models/v90/specifications/features		/uk/cars/v90/	 *						
/uk/cars/new-models/v90/specifications		/uk/cars/v90/			 *				
/uk/cars/new-models/v90/specifications/trims-comparison		/uk/cars/v90/	 *						
/uk/cars/new-models/xc40/specifications/dimensions		/uk/cars/xc40/ *							
/uk/cars/new-models/xc40/specifications/engines		/uk/cars/xc40/		 *					
/uk/cars/new-models/xc40/specifications/features		/uk/cars/xc40/	 *						
/uk/cars/new-models/xc40/specifications		/uk/cars/xc40/  *							
/uk/cars/new-models/xc40/specifications/trims-comparison		/uk/cars/xc40/  *							
/uk/cars/new-models/xc60/specifications/engines		/uk/cars/xc60/	*						
/uk/cars/new-models/xc60/specifications/features		/uk/cars/xc60/	*						
/uk/cars/new-models/xc60/specifications		/uk/cars/xc60/	*						
/uk/cars/new-models/xc60/specifications/trims-comparison		/uk/cars/xc60/  *							
/uk/cars/new-models/xc90/specifications/engines		/uk/cars/xc90/	*						
/uk/cars/new-models/xc90/specifications/features		/uk/cars/xc90/	*						
/uk/cars/new-models/xc90/specifications		/uk/cars/xc90/		*					
/uk/cars/new-models/xc90/specifications/trim-comparison		/uk/cars/xc90/	*	
/gt/cars/new-models/new-s60/specifications/dimensions		/gt *							
/gt/cars/new-models/new-s60/specifications/engines		/gt		 *					
/gt/cars/new-models/new-s60/specifications/features		/gt	 *						
/gt/cars/new-models/new-s60/specifications		/gt		 *					
/gt/cars/new-models/new-s60/specifications/trims-comparison		/gt	 *	
/uk/cars/new-models/s60  /uk/cars/s60/  *
/uk/cars/new-models/v60  /uk/cars/v60/  *
/uk/cars/new-models/v90  /uk/cars/v90/  *
/uk/cars/new-models/xc40  /uk/cars/xc40/  *
/uk/cars/new-models/xc60  /uk/cars/xc60/  *
/ar-qa/cars/concept-cars	/ar-qa/v/cars/concept-models  *
/ar-qa/cars/concept-cars/360c  /ar-qa/v/cars/concept-models/360c  *
/ar-qa/cars/concept-cars/ambience-interior	/ar-qa/v/cars/concept-models/ambience  *
/ar-qa/cars/concept-cars/concept-40	/ar-qa/v/cars/concept-models/concept-40  *
/ar-qa/cars/concept-cars/concept-coupe	/ar-qa/v/cars/concept-models/concept-coupe  *
/ar-qa/cars/concept-cars/concept-estate  /ar-qa/v/cars/concept-models/concept-estate  *
/ar-qa/cars/concept-cars/concept-xc-coupe	/ar-qa/v/cars/concept-models/concept-xc-coupe  *
##Expiry 2023-04-20
/tw/cars/concepts	/tw/v/cars/concept-models  *
/tw/cars/concepts/360c	/tw/v/cars/concept-models/360c  *
/tw/cars/concepts/ambience-interior	/tw/v/cars/concept-models/ambience  *
/tw/cars/concepts/concept-40	/tw/v/cars/concept-models/concept-40  *
/tw/cars/concepts/concept-coupe	/tw/v/cars/concept-models/concept-coupe  *
/tw/cars/concepts/concept-estate	/tw/v/cars/concept-models/concept-estate  *
/tw/cars/concepts/concept-xc-coupe	/tw/v/cars/concept-models/concept-xc-coupe  *
/ro-md/cars/concepte	/ro-md/v/cars/concept-models  *
/ro-md/cars/concepte/360c	/ro-md/v/cars/concept-models/360c  *
/ro-md/cars/concepte/concept-coupe	/ro-md/v/cars/concept-models/concept-coupe  *
/ro-md/cars/concepte/concept-estate	/ro-md/v/cars/concept-models/concept-estate  *
/ro-md/cars/concepte/concept-xc-coupe	/ro-md/v/cars/concept-models/concept-xc-coupe  *
/ru-md/cars/concepte	/ru-md/v/cars/concept-models  *
/ru-md/cars/concepte/360c	/ru-md/v/cars/concept-models/360c  *
/ru-md/cars/concepte/concept-coupe	/ru-md/v/cars/concept-models/concept-coupe  *
/ru-md/cars/concepte/concept-estate	/ru-md/v/cars/concept-models/concept-estate  *
/ru-md/cars/concepte/concept-xc-coupe	/ru-md/v/cars/concept-models/concept-xc-coupe  *
/mt/cars/new-models/xc60/specifications/dimensions		/mt/cars/xc60/  *
/mt/cars/new-models/xc60/specifications/engines		/mt/cars/xc60/  *
/mt/cars/new-models/xc60/specifications/features		/mt/cars/xc60/  *
/mt/cars/new-models/xc60/specifications		/mt/cars/xc60/  *
/mt/cars/new-models/xc60/specifications/trims-comparison		/mt/cars/xc60/  *
/mt/cars/new-models/xc90/specifications/dimensions		/mt/cars/xc90/  *
/mt/cars/new-models/xc90/specifications/engines		/mt/cars/xc90/  *
/mt/cars/new-models/xc90/specifications/features		/mt/cars/xc90/  *
/mt/cars/new-models/xc90/specifications		/mt/cars/xc90/  *
/mt/cars/new-models/xc90/specifications/trim-comparison		/mt/cars/xc90/  *

##Expiry 2023-02-25
##Expiry 2023-04-04
/ie/cars/concept-cars	/ie/v/cars/concept-models  *
/ie/cars/concept-cars/360c	/ie/v/cars/concept-models/360c	  *
/ie/cars/concept-cars/concept-26 /ie/v/cars/concept-models  *
/ie/cars/concept-cars/concept-xc-coupe	/ie/v/cars/concept-models/concept-xc-coupe  *
##Expiry 2023-04-15
/jp/cars/concepts	/jp/v/cars/concept-models  *
/jp/cars/concepts/360c	/jp/v/cars/concept-models/360c  *
/jp/cars/concepts/concept-coupe	/jp/v/cars/concept-models/concept-coupe  *
/jp/cars/concepts/concept-estate	/jp/v/cars/concept-models/concept-estate  *
/jp/cars/concepts/concept-xc-coupe	/jp/v/cars/concept-models/concept-xc-coupe  *
/bg/cars/концептуални-автомобили	/bg/v/cars/concept-models  *
/bg/cars/концептуални-автомобили/360c	/bg/v/cars/concept-models/360c  *
/bg/cars/концептуални-автомобили/концепция-40	/bg/v/cars/concept-models/concept-40  *
/bg/cars/концептуални-автомобили/концепция-комби	/bg/v/cars/concept-models/concept-estate  *
/bg/cars/концептуални-автомобили/концепция-купе	/bg/v/cars/concept-models/concept-coupe  *
/bg/cars/концептуални-автомобили/концепция-хс	/bg/v/cars/concept-models/concept-xc-coupe  *
/bg/cars/%D0%BD%D0%BE%D0%B2%D0%B8-%D0%BC%D0%BE%D0%B4%D0%B5%D0%BB%D0%B8/s60  /bg/v/cars/s60  *
/bg/cars/%D0%BD%D0%BE%D0%B2%D0%B8-%D0%BC%D0%BE%D0%B4%D0%B5%D0%BB%D0%B8/s90  /bg/v/cars/s90  *
/bg/cars/%D0%BD%D0%BE%D0%B2%D0%B8-%D0%BC%D0%BE%D0%B4%D0%B5%D0%BB%D0%B8/v60  /bg/v/cars/v60  *
/bg/cars/%D0%BD%D0%BE%D0%B2%D0%B8-%D0%BC%D0%BE%D0%B4%D0%B5%D0%BB%D0%B8/v60cc  /bg/v/cars/v60-cross-country  *
/bg/cars/%D0%BD%D0%BE%D0%B2%D0%B8-%D0%BC%D0%BE%D0%B4%D0%B5%D0%BB%D0%B8/v90cc  /bg/v/cars/v90-cross-country  *
/bg/cars/%D0%BD%D0%BE%D0%B2%D0%B8-%D0%BC%D0%BE%D0%B4%D0%B5%D0%BB%D0%B8/xc40  /bg/v/cars/xc40  *
/bg/cars/%D0%BD%D0%BE%D0%B2%D0%B8-%D0%BC%D0%BE%D0%B4%D0%B5%D0%BB%D0%B8/xc60  /bg/v/cars/xc60  *
/bg/cars/%D0%BD%D0%BE%D0%B2%D0%B8-%D0%BC%D0%BE%D0%B4%D0%B5%D0%BB%D0%B8/xc90  /bg/v/cars/xc90  *
/en-eg/cars/concept-cars	/en-eg/v/cars/concept-models  *
/en-eg/cars/concept-cars/360c	/en-eg/v/cars/concept-models/360c  *
/en-eg/cars/concept-cars/concept-coupe	/en-eg/v/cars/concept-models/concept-coupe  *
/en-eg/cars/concept-cars/concept-estate	/en-eg/v/cars/concept-models/concept-estate  *
/en-eg/cars/concept-cars/concept-xc-coupe	/en-eg/v/cars/concept-models/concept-xc-coupe  *
/ar-eg/cars/concept-cars	/ar-eg/v/cars/concept-models  *
/ar-eg/cars/concept-cars/360c	/ar-eg/v/cars/concept-models/360c  *
/ar-eg/cars/concept-cars/concept-coupe	/ar-eg/v/cars/concept-models/concept-coupe  *
/ar-eg/cars/concept-cars/concept-estate	/ar-eg/v/cars/concept-models/concept-estate  *
/ar-eg/cars/concept-cars/concept-xc-coupe	/ar-eg/v/cars/concept-models/concept-xc-coupe  *
/mu/cars/concepts	/mu/v/cars/concept-models  *
/mu/cars/concepts/360c	/mu/v/cars/concept-models/360c  *
/mu/cars/concepts/ambience-interior	/mu/v/cars/concept-models/ambience  *
/mu/cars/concepts/concept-40	/mu/v/cars/concept-models/concept-40  *
/mu/cars/concepts/concept-coupe	/mu/v/cars/concept-models/concept-coupe  *
/mu/cars/concepts/concept-estate	/mu/v/cars/concept-models/concept-estate  *
/mu/cars/concepts/concept-xc	/mu/v/cars/concept-models/concept-xc-coupe  *
/ro-md/cars/gama-de-modele/s90/specifications/dimensions		/ro-md/cars/s90/  *
/ro-md/cars/gama-de-modele/s90/specifications/engines		/ro-md/cars/s90/  *
/ro-md/cars/gama-de-modele/s90/specifications/trims-comparison		/ro-md/cars/s90/  *
/ro-md/cars/gama-de-modele/xc40/specifications/dimensions		/ro-md/cars/xc40/  *
/ro-md/cars/gama-de-modele/xc40/specifications/engines		/ro-md/cars/xc40/  *
/ro-md/cars/gama-de-modele/xc40/specifications/trims-comparison		/ro-md/cars/xc40/  *
/ro-md/cars/gama-de-modele/xc60/specifications/dimensions		/ro-md/cars/xc60/  *
/ro-md/cars/gama-de-modele/xc60/specifications/engines		/ro-md/cars/xc60/  *
/ro-md/cars/gama-de-modele/xc60/specifications/trims-comparison		/ro-md/cars/xc60/  *
/ro-md/cars/gama-de-modele/xc90/specifications/dimensions		/ro-md/cars/xc90/  *
/ro-md/cars/gama-de-modele/xc90/specifications/engines		/ro-md/cars/xc90/  *
/ro-md/cars/gama-de-modele/xc90/specifications/trims-comparison		/ro-md/cars/xc90/  *
/ru-md/cars/new-models/s90/specifications/dimensions		/ru-md/cars/s90/  *
/ru-md/cars/new-models/s90/specifications/engines		/ru-md/cars/s90/  *
/ru-md/cars/new-models/s90/specifications/trims-comparison		/ru-md/cars/s90/  *
/ru-md/cars/new-models/xc40/specifications/dimensions		/ru-md/cars/xc40/  *
/ru-md/cars/new-models/xc40/specifications/engines		/ru-md/cars/xc40/  *
/ru-md/cars/new-models/xc40/specifications/trims-comparison		/ru-md/cars/xc40/  *
/ru-md/cars/new-models/xc60/specifications/dimensions		/ru-md/cars/xc60/  *
/ru-md/cars/new-models/xc60/specifications/engines		/ru-md/cars/xc60/  *
/ru-md/cars/new-models/xc60/specifications/trims-comparison		/ru-md/cars/xc60/  *
/ru-md/cars/new-models/xc90/specifications/dimensions		/ru-md/cars/xc90/  *
/ru-md/cars/new-models/xc90/specifications/engines		/ru-md/cars/xc90/  *
/ru-md/cars/new-models/xc90/specifications/trims-comparison		/ru-md/cars/xc90/ *
/en-om/cars/concept-cars	 /en-om/v/cars/concept-models  *
/en-om/cars/concept-cars/360c	/en-om/v/cars/concept-models/360c  *
/en-om/cars/concept-cars/ambience-interior	/en-om/v/cars/concept-models/ambience  *
/en-om/cars/concept-cars/concept-40	/en-om/v/cars/concept-models/concept-40  *
/en-om/cars/concept-cars/concept-coupe	  /en-om/v/cars/concept-models/concept-coupe  *
/en-om/cars/concept-cars/concept-estate	/en-om/v/cars/concept-models/concept-estate  *
/en-om/cars/concept-cars/concept-xc-coupe	/en-om/v/cars/concept-models/concept-xc-coupe	  *
/ar-om/cars/concept-cars	 /ar-om/v/cars/concept-models  *
/ar-om/cars/concept-cars/360c	/ar-om/v/cars/concept-models/360c  *
/ar-om/cars/concept-cars/ambience-interior /ar-om/v/cars/concept-models/ambience  *
/ar-om/cars/concept-cars/concept-40	/ar-om/v/cars/concept-models/concept-40  *
/ar-om/cars/concept-cars/concept-coupe	  /ar-om/v/cars/concept-models/concept-coupe  *
/ar-om/cars/concept-cars/concept-estate	/ar-om/v/cars/concept-models/concept-estate  *
/ar-om/cars/concept-cars/concept-xc-coupe	/ar-om/v/cars/concept-models/concept-xc-coupe  *
/ro/cars/modele-concept	/ro/v/cars/concept-models  *
/ro/cars/modele-concept/360c	/ro/v/cars/concept-models/360c  *
/ro/cars/modele-concept/concept-coupe	/ro/v/cars/concept-models/concept-coupe  *
/ro/cars/modele-concept/concept-estate	/ro/v/cars/concept-models/concept-estate  *
/ro/cars/modele-concept/concept-xc-coupe	/ro/v/cars/concept-models/concept-xc-coupe  *
/en-sa/cars/concept-cars	/en-sa/v/cars/concept-models  *
/en-sa/cars/concept-cars/360c	/en-sa/v/cars/concept-models  *
/en-sa/cars/concept-cars/ambience-interior	/en-sa/v/cars/concept-models/ambience  *
/en-sa/cars/concept-cars/concept-40	/en-sa/v/cars/concept-models/concept-40  *
/en-sa/cars/concept-cars/concept-coupe	/en-sa/v/cars/concept-models/concept-coupe	  *
/en-sa/cars/concept-cars/concept-estate	/en-sa/v/cars/concept-models/concept-estate  *
/en-sa/cars/concept-cars/concept-xc-coupe	/en-sa/v/cars/concept-models/concept-xc-coupe  *
/ar-sa/cars/concept-cars	/ar-sa/v/cars/concept-models  *
/ar-sa/cars/concept-cars/360c	/ar-sa/v/cars/concept-models/360c  *
/ar-sa/cars/concept-cars/ambience-interior	/ar-sa/v/cars/concept-models/ambience  *
/ar-sa/cars/concept-cars/concept-40	/ar-sa/v/cars/concept-models/concept-40  *
/ar-sa/cars/concept-cars/concept-coupe	/ar-sa/v/cars/concept-models/concept-coupe  *
/ar-sa/cars/concept-cars/concept-estate	/ar-sa/v/cars/concept-models/concept-estate  *
/ar-sa/cars/concept-cars/concept-xc-coupe	/ar-sa/v/cars/concept-models/concept-xc-coupe  *
/mk/cars/concept-cars	/mk/v/cars/concept-models  *
/mk/cars/concept-cars/concept-coupe	/mk/v/cars/concept-models/concept-coupe  *
/mk/cars/concept-cars/concept-estate	/mk/v/cars/concept-models/concept-estate  *
/mk/cars/concept-cars/concept-xc-coupe	/mk/v/cars/concept-models/concept-xc-coupe  *
/mt/cars/concepts	/mt/v/cars/concept-models  *
/mt/cars/concepts/360c	/mt/v/cars/concept-models/360c  *
/mt/cars/concepts/ambience-interior	/mt/v/cars/concept-models/ambience  *
/mt/cars/concepts/concept-40  /mt/v/cars/concept-models/concept-40  *
/mt/cars/concepts/concept-coupe	/mt/v/cars/concept-models/concept-coupe  *
/mt/cars/concepts/concept-estate	/mt/v/cars/concept-models/concept-estate  *
/mt/cars/concepts/concept-xc	/mt/v/cars/concept-models/concept-xc-coupe  *
/me/cars/concept-cars	/me/v/cars/concept-models  *
/me/cars/concept-cars/concept-coupe	/me/v/cars/concept-models/concept-coupe  *
/me/cars/concept-cars/concept-estate	/me/v/cars/concept-models/concept-estate  *
/me/cars/concept-cars/concept-xc-coupe	/me/v/cars/concept-models/concept-xc-coupe  *
/ar-ae/cars/concept-cars	/ar-ae/v/cars/concept-models  *
/ar-ae/cars/concept-cars/360c	/ar-ae/v/cars/concept-models/360c  *
/ar-ae/cars/concept-cars/ambience-interior	/ar-ae/v/cars/concept-models/ambience  *
/ar-ae/cars/concept-cars/concept-40	/ar-ae/v/cars/concept-models/concept-40  *
/ar-ae/cars/concept-cars/concept-coupe	/ar-ae/v/cars/concept-models/concept-coupe  *
/ar-ae/cars/concept-cars/concept-estate	/ar-ae/v/cars/concept-models/concept-estate  *
/ar-ae/cars/concept-cars/concept-xc-coupe	/ar-ae/v/cars/concept-models/concept-xc-coupe  *
/au/cars/dcoty21  /au/l/dcoty  *
/dk/cars/concept-cars/360c	/dk/v/cars/concept-models/360c  *
/dk/cars/concept-cars/concept-coupe	/dk/v/cars/concept-models/concept-coupe  *
/dk/cars/concept-cars/concept-estate	/dk/v/cars/concept-models/concept-estate  *
/dk/cars/concept-cars/concept-xc-coupe	/dk/v/cars/concept-models/concept-xc-coupe  *
/dk/cars/iframeprivatleasing  /dk/l/leasing/privatleasing/  *



##Expiry 2023-02-01
/in/cars/concept-cars	/in/v/cars/concept-models  *
/in/cars/concept-cars/concept-coupe	/in/v/cars/concept-models/concept-coupe  *
##expiry 2023-02-15
/en-th/cars/concept-cars	/en-th/v/cars/concept-models  *
/en-th/cars/concept-cars/concept-coupe	/en-th/v/cars/concept-models/concept-coupe  *
/en-th/cars/concept-cars/concept-estate	/en-th/v/cars/concept-models/concept-estate  *
/en-th/cars/concept-cars/concept-xc-coupe	/en-th/v/cars/concept-models/concept-xc-coupe  *
/th-th/cars/concept-cars  /th-th/v/cars/concept-models  *
/th-th/cars/concept-cars/concept-coupe /th-th/v/cars/concept-models/concept-coupe  *
/th-th/cars/concept-cars/concept-estate	/th-th/v/cars/concept-models/concept-estate  *
/th-th/cars/concept-cars/concept-xc-coupe	/th-th/v/cars/concept-models/concept-xc-coupe  *
##Expiry 2023-04-04
/uk/cars/business-sales/affinity/offers  /uk/l/offers/affinity/  *
/uk/cars/business-sales/affinity/offers/s90  /uk/l/offers/affinity/  *
/uk/cars/business-sales/affinity/offers/s60  /uk/l/offers/affinity/  *
/uk/cars/business-sales/affinity/offers/v90  /uk/l/offers/affinity/  *
/uk/cars/business-sales/affinity/offers/v60  /uk/l/offers/affinity/  *
/uk/cars/business-sales/affinity/offers/xc40  /uk/l/offers/affinity/  *
/uk/cars/business-sales/affinity/offers/xc60  /uk/l/offers/affinity/  *
/uk/cars/business-sales/affinity/offers/xc90  /uk/l/offers/affinity/  *
/uk/cars/offers  /uk/l/offers/  *
/uk/cars/business-sales/contact  /uk/l/fleet-and-business/contact/  *
/uk/cars/business-sales/demo  /uk/l/fleet-and-business/demo/  *
/uk/cars/used-cars  /uk/l/used-cars/  *
/uk/cars/new-models/xc90/offers  /uk/l/offers/xc90/  *
/uk/cars/new-models/xc60/offers  /uk/l/offers/xc60/  *
/uk/cars/new-models/xc40/offers  /uk/l/offers/xc40/  *
/uk/cars/new-models/v90/offers  /uk/l/offers/v90/  *
/uk/cars/ebrochure  /uk/l/pricelists/  *
/uk/cars/new-models/v60/offers  /uk/l/offers/v60/  *
/uk/cars/new-models/s90/offers  /uk/l/offers/s90/  *


/uk/cars/model-lineup/estate  /uk/v/cars/wagon  *
/uk/cars/model-lineup/saloon  /uk/v/cars/sedan  *
/uk/cars/model-lineup/suv-crossover  /uk/v/cars/suv  *


## cars namespace
##Expiry 2023-02-01
/in/cars/new-models/all-new-s90	/in/cars/s90/	*
/in/cars/new-models/s90  /in/cars/s90/  *
/in/cars/new-models/sedan  /in/v/cars/sedan  *
/in/cars/new-models/suv  /in/v/cars/suv  *
/in/cars/new-models/the-new-xc60	/in/cars/xc60/	*
/in/cars/new-models/v90-cross-country	/	*
/in/cars/new-models/xc40  /in/v/cars/xc40  *
/in/cars/new-models/xc60  /in/cars/xc60/  *
/in/cars/new-models/xc90  /in/v/cars/xc90  *

##Expiry 2023-04-15
/de/Cars/New-Models/XC60/360-Tour	 /de/cars/xc60-hybrid/  *
/en-qa/cars/new-models/s60  /en-qa/cars/s60/  *
/en-qa/cars/new-models/s60/trims	/en-qa/cars/s60/	*
/en-qa/cars/new-models/s60/trims/inscription	/en-qa/cars/s60/	*
/en-qa/cars/new-models/s60/trims/r-design	/en-qa/cars/s60/	*
/en-qa/cars/new-models/s90  /en-qa/cars/s90/  *
/en-qa/cars/new-models/s90/trims	/en-qa/cars/s90/	*
/en-qa/cars/new-models/s90/trims/inscription	/en-qa/cars/s90/	*
/en-qa/cars/new-models/s90/trims/momentum	/en-qa/cars/s90/	*
/en-qa/cars/new-models/s90/trims/r-design	/en-qa/cars/s90/	*
/en-qa/cars/new-models/xc40  /en-qa/v/cars/xc40  *
/en-qa/cars/new-models/xc40/trims	/en-qa/v/cars/xc40	*
/en-qa/cars/new-models/xc40/trims/inscription	/en-qa/v/cars/xc40	*
/en-qa/cars/new-models/xc40/trims/momentum	/en-qa/v/cars/xc40  *
/en-qa/cars/new-models/xc40/trims/r-design	/en-qa/v/cars/xc40	*
/en-qa/cars/new-models/xc60  /en-qa/cars/xc60/  *
/en-qa/cars/new-models/xc60/trims	/en-qa/cars/xc60/	*
/en-qa/cars/new-models/xc60/trims/inscription	/en-qa/cars/xc60/	*
/en-qa/cars/new-models/xc60/trims/momentum	/en-qa/cars/xc60/	*
/en-qa/cars/new-models/xc60/trims/r-design	/en-qa/cars/xc60/	*
/en-qa/cars/new-models/xc90  /en-qa/cars/xc90/  *
/en-qa/cars/new-models/xc90/trims	/en-qa/cars/xc90/	*
/en-qa/cars/new-models/xc90/trims/inscription  /en-qa/cars/xc90/	*
/en-qa/cars/new-models/xc90/trims/momentum	/en-qa/cars/xc90/	*
/en-qa/cars/new-models/xc90/trims/r-design	/en-qa/cars/xc90/	*
##Expiry 2023-04-20
/tw/cars/new-models/s60  /tw/cars/s60  *
/tw/cars/new-models/s90  /tw/v/cars/s90  *
/tw/cars/new-models/the-new-v90-cross-country  /tw/v/cars/v90-cross-country  *
/tw/cars/new-models/the-new-xc90  /tw/v/cars/xc90  *
/tw/cars/new-models/v60  /tw/cars/v60  *
/tw/cars/new-models/xc40  /tw/v/cars/xc40  *
/tw/cars/new-models/xc60  /tw/cars/xc60  *
##Expiry 2023-04-01
##Expiry 2023-04-03
/ie/cars/new-models/v60/offer  /ie/l/offers/  *
/ie/cars/new-models/xc60/offers  /ie/l/offers/xc60-offers/  *
/ie/cars/new-models/xc90/offers  /ie/l/offers/xc90-offers/  *
##Expiry 2023-04-18
/ar-bh/cars/new-models/s60  /ar-bh/cars/s60/  *
/ar-bh/cars/new-models/s60/trims	/ar-bh/cars/s60/	*
/ar-bh/cars/new-models/s60/trims/inscription	/ar-bh/cars/s60/	*
/ar-bh/cars/new-models/s60/trims/r-design	/ar-bh/cars/s60/	*
/ar-bh/cars/new-models/s90  /ar-bh/cars/s90/  *
/ar-bh/cars/new-models/s90/trims	/ar-bh/cars/s90/	*
/ar-bh/cars/new-models/s90/trims/inscription	/ar-bh/cars/s90/	*
/ar-bh/cars/new-models/s90/trims/momentum	/ar-bh/cars/s90/	*
/ar-bh/cars/new-models/s90/trims/r-design	/ar-bh/cars/s90/	*
/ar-bh/cars/new-models/v60  /ar-bh  *
/ar-bh/cars/new-models/xc40  /ar-bh/v/cars/xc40  *
/ar-bh/cars/new-models/xc40/trims	/ar-bh/v/cars/xc40	*
/ar-bh/cars/new-models/xc40/trims/inscription	/ar-bh/v/cars/xc40	*
/ar-bh/cars/new-models/xc40/trims/momentum	/ar-bh/v/cars/xc40	*
/ar-bh/cars/new-models/xc40/trims/r-design	/ar-bh/v/cars/xc40	*
/ar-bh/cars/new-models/xc60  /ar-bh/cars/xc60/  *
/ar-bh/cars/new-models/xc60/trims	/ar-bh/cars/xc60/	*
/ar-bh/cars/new-models/xc60/trims/inscription	/ar-bh/cars/xc60/	*
/ar-bh/cars/new-models/xc60/trims/momentum	/ar-bh/cars/xc60/	*
/ar-bh/cars/new-models/xc60/trims/r-design	/ar-bh/cars/xc60/	*
/ar-bh/cars/new-models/xc90  /ar-bh/cars/xc90/  *
/ar-bh/cars/new-models/xc90/trims	/ar-bh/cars/xc90/	*
/ar-bh/cars/new-models/xc90/trims/inscription	/ar-bh/cars/xc90/	*
/ar-bh/cars/new-models/xc90/trims/momentum	/ar-bh/cars/xc90/	*
/ar-bh/cars/new-models/xc90/trims/r-design	/ar-bh/cars/xc90/	*
/en-bh/cars/new-models/s60  /en-bh/cars/s60/  *
/en-bh/cars/new-models/s60/trims	/en-bh/cars/s60/	*
/en-bh/cars/new-models/s60/trims/inscription	/en-bh/cars/s60/	*
/en-bh/cars/new-models/s60/trims/r-design	/en-bh/cars/s60/	*
/en-bh/cars/new-models/s90  /en-bh/cars/s90/  *
/en-bh/cars/new-models/s90/trims	/en-bh/cars/s90/	*
/en-bh/cars/new-models/s90/trims/inscription	/en-bh/cars/s90/	*
/en-bh/cars/new-models/s90/trims/momentum	/en-bh/cars/s90/	*
/en-bh/cars/new-models/s90/trims/r-design	/en-bh/cars/s90/	*
/en-bh/cars/new-models/v60  /en-bh  *
/en-bh/cars/new-models/xc40  /en-bh/v/cars/xc40  *
/en-bh/cars/new-models/xc40/trims	/en-bh/v/cars/xc40	*
/en-bh/cars/new-models/xc40/trims/inscription  /en-bh/v/cars/xc40  *
/en-bh/cars/new-models/xc40/trims/momentum	/en-bh/v/cars/xc40	*
/en-bh/cars/new-models/xc40/trims/r-design	/en-bh/v/cars/xc40	*
/en-bh/cars/new-models/xc60  /en-bh/cars/xc60/  *
/en-bh/cars/new-models/xc60/trims	/en-bh/cars/xc60/	*
/en-bh/cars/new-models/xc60/trims/inscription	/en-bh/cars/xc60/	*
/en-bh/cars/new-models/xc60/trims/momentum	/en-bh/cars/xc60/	*
/en-bh/cars/new-models/xc60/trims/r-design	/en-bh/cars/xc60/	*
/en-bh/cars/new-models/xc90  /en-bh/cars/xc90/  *
/en-bh/cars/new-models/xc90/trims	/en-bh/cars/xc90/	*
/en-bh/cars/new-models/xc90/trims/inscription	/en-bh/cars/xc90/	*
/en-bh/cars/new-models/xc90/trims/momentum	/en-bh/cars/xc90/	*
/en-bh/cars/new-models/xc90/trims/r-design	/en-bh/cars/xc90/	*
##Expiry 2023-04-18
/en-ae/cars/concept-cars	/en-ae/v/cars/concept-models  *
/en-ae/cars/concept-cars/360c	/en-ae/v/cars/concept-models/360c  *
/en-ae/cars/concept-cars/ambience-interior	/en-ae/v/cars/concept-models/ambience  *
/en-ae/cars/concept-cars/concept-40	/en-ae/v/cars/concept-models/concept-40  *
/en-ae/cars/concept-cars/concept-coupe	/en-ae/v/cars/concept-models/concept-coupe  *
/en-ae/cars/concept-cars/concept-estate	/en-ae/v/cars/concept-models/concept-estate  *
/en-ae/cars/concept-cars/concept-xc-coupe	/en-ae/v/cars/concept-models/concept-xc-coupe  *
/ar-eg/cars/new-models/v60  /ar-eg/v/cars/v60  *
/ar-eg/cars/new-models/xc40  /ar-eg/v/cars/xc40  *
/ar-eg/cars/new-models/xc40/trims	/ar-eg/v/cars/xc40	*
/ar-eg/cars/new-models/xc40/trims/inscription	/ar-eg/v/cars/xc40	*
/ar-eg/cars/new-models/xc40/trims/momentum	/ar-eg/v/cars/xc40	*
/ar-eg/cars/new-models/xc40/trims/r-design	/ar-eg/v/cars/xc40	*
/ar-eg/cars/new-models/xc60  /ar-eg/v/cars/xc60  *
/ar-eg/cars/new-models/xc60/trims	/ar-eg/v/cars/xc60	*
/ar-eg/cars/new-models/xc60/trims/inscription	/ar-eg/v/cars/xc60	*
/ar-eg/cars/new-models/xc60/trims/momentum	/ar-eg/v/cars/xc60	*
/ar-eg/cars/new-models/xc60/trims/r-design	/ar-eg/v/cars/xc60	*
/ar-eg/cars/new-models/xc90  /ar-eg/v/cars/xc90  *
/ar-eg/cars/new-models/xc90/trims	/ar-eg/v/cars/xc90	*
/ar-eg/cars/new-models/xc90/trims/inscription	/ar-eg/v/cars/xc90	*
/en-eg/cars/new-models/xc40  /en-eg/v/cars/xc40  *
/en-eg/cars/new-models/xc40/trims	/en-eg/v/cars/xc40	*
/en-eg/cars/new-models/xc40/trims/inscription	/en-eg/v/cars/xc40	*
/en-eg/cars/new-models/xc40/trims/momentum	/en-eg/v/cars/xc40	*
/en-eg/cars/new-models/xc40/trims/r-design	/en-eg/v/cars/xc40	*
/en-eg/cars/new-models/xc60  /en-eg/v/cars/xc60  *
/en-eg/cars/new-models/xc60/trims	/en-eg/v/cars/xc60	*
/en-eg/cars/new-models/xc60/trims/inscription	/en-eg/v/cars/xc60	*
/en-eg/cars/new-models/xc60/trims/momentum	/en-eg/v/cars/xc60	*
/en-eg/cars/new-models/xc60/trims/r-design	/en-eg/v/cars/xc60	*
/en-eg/cars/new-models/xc90  /en-eg/v/cars/xc90  *
/en-eg/cars/new-models/xc90/trims	/en-eg/v/cars/xc90	*
/en-eg/cars/new-models/xc90/trims/inscription	/en-eg/v/cars/xc90	*
/mu/cars/new-models/s60  /mu/cars/s60-hybrid/  *
/mu/cars/new-models/s60/trims	/mu/cars/s60-hybrid/	*
/mu/cars/new-models/s60/trims/momentum	/mu/cars/s60-hybrid/	*
/mu/cars/new-models/s60/trims/r-design	/mu/cars/s60-hybrid/	*
/mu/cars/new-models/s90  /mu/cars/s90/  *
/mu/cars/new-models/s90/trims	/mu/cars/s90/	*
/mu/cars/new-models/s90/trims/inscription	/mu/cars/s90/	*
/mu/cars/new-models/xc40  /mu/cars/xc40-hybrid/  *
/mu/cars/new-models/xc40/trims	/mu/cars/xc40-hybrid/	*
/mu/cars/new-models/xc40/trims/momentum	/mu/cars/xc40-hybrid/	*
/mu/cars/new-models/xc40/trims/r-design	/mu/cars/xc40-hybrid/	*
/mu/cars/new-models/xc60  /mu/cars/xc60/  *
/mu/cars/new-models/xc60/trims	/mu/cars/xc60/	*
/mu/cars/new-models/xc60/trims/momentum	/mu/cars/xc60/	*
/mu/cars/new-models/xc90  /mu/cars/xc90/  *
/mu/cars/new-models/xc90/trims	/mu/cars/xc90/	*
/mu/cars/new-models/xc90/trims/inscription	/mu/cars/xc90/	*
/mu/cars/new-models/xc90/trims/momentum	/mu/cars/xc90/	*
/ar-om/cars/new-models/s60  /ar-om/v/cars/s60  *
/ar-om/cars/new-models/s60/trims	/ar-om/v/cars/s60	*
/ar-om/cars/new-models/s60/trims/inscription	/ar-om/v/cars/s60	*
/ar-om/cars/new-models/s60/trims/r-design	/ar-om/v/cars/s60	*
/ar-om/cars/new-models/s90  /ar-om/v/cars/s90  *
/ar-om/cars/new-models/s90/trims	/ar-om/v/cars/s90	*
/ar-om/cars/new-models/s90/trims/inscription	/ar-om/v/cars/s90	*
/ar-om/cars/new-models/s90/trims/momentum	/ar-om/v/cars/s90	*
/ar-om/cars/new-models/s90/trims/r-design	/ar-om/v/cars/s90	*
/ar-om/cars/new-models/v60  /ar-om/v/cars/v60  *
/ar-om/cars/new-models/v90cc  /ar-om/v/cars/v90-cross-country  *
/ar-om/cars/new-models/xc40  /ar-om/v/cars/xc40/  *
/ar-om/cars/new-models/xc40/trims	/ar-om/v/cars/xc40	*
/ar-om/cars/new-models/xc40/trims/inscription	/ar-om/v/cars/xc40	*
/ar-om/cars/new-models/xc40/trims/momentum	/ar-om/v/cars/xc40	*
/ar-om/cars/new-models/xc40/trims/r-design	/ar-om/v/cars/xc40	*
/ar-om/cars/new-models/xc60  /ar-om/v/cars/xc60/  *
/ar-om/cars/new-models/xc60/trims	/ar-om/v/cars/xc60	*
/ar-om/cars/new-models/xc60/trims/inscription	/ar-om/v/cars/xc60	*
/ar-om/cars/new-models/xc60/trims/momentum	/ar-om/v/cars/xc60	*
/ar-om/cars/new-models/xc60/trims/r-design	/ar-om/v/cars/xc60	*
/ar-om/cars/new-models/xc90  /ar-om/v/cars/xc90  *
/ar-om/cars/new-models/xc90/trims	/ar-om/v/cars/xc90	*
/ar-om/cars/new-models/xc90/trims/inscription	/ar-om/v/cars/xc90	*
/ar-om/cars/new-models/xc90/trims/momentum	/ar-om/v/cars/xc90	*
/ar-om/cars/new-models/xc90/trims/r-design	/ar-om/v/cars/xc90	*
/en-om/cars/new-models/s90  /en-om/v/cars/s90  *
/en-om/cars/new-models/s90/trims	/en-om/v/cars/s90	*
/en-om/cars/new-models/s90/trims/inscription	/en-om/v/cars/s90	*
/en-om/cars/new-models/s90/trims/momentum	/en-om/v/cars/s90	*
/en-om/cars/new-models/s90/trims/r-design	/en-om/v/cars/s90	*
/en-om/cars/new-models/v60  /en-om/v/cars/v60  *
/en-om/cars/new-models/v90cc  /en-om/v/cars/v90-cross-country  *
/en-om/cars/new-models/xc40  /en-om/v/cars/xc40  *
/en-om/cars/new-models/xc40/trims	/en-om/v/cars/xc40  	*
/en-om/cars/new-models/xc40/trims/inscription	/en-om/v/cars/xc40	*
/en-om/cars/new-models/xc40/trims/momentum	/en-om/v/cars/xc40	*
/en-om/cars/new-models/xc40/trims/r-design	/en-om/v/cars/xc40	*
/en-om/cars/new-models/xc60  /en-om/v/cars/xc60  *
/en-om/cars/new-models/xc60/trims	/en-om/v/cars/xc60	*
/en-om/cars/new-models/xc60/trims/inscription	/en-om/v/cars/xc60	*
/en-om/cars/new-models/xc60/trims/momentum	/en-om/v/cars/xc60	*
/en-om/cars/new-models/xc60/trims/r-design	/en-om/v/cars/xc60	*
/en-om/cars/new-models/xc90  /en-om/v/cars/xc90  *
/en-om/cars/new-models/xc90/trims	/en-om/v/cars/xc90	*
/en-om/cars/new-models/xc90/trims/inscription	/en-om/v/cars/xc90	*
/en-om/cars/new-models/xc90/trims/momentum	/en-om/v/cars/xc90	*
/en-om/cars/new-models/xc90/trims/r-design	/en-om/v/cars/xc90	*
/ro/cars/modele-noi/v426	/ro/cars/xc60/	*
/ro/cars/modele-noi/xc60	/ro/cars/xc60/	*
/ro/cars/new-models/s60  /ro/cars/s60/  *
/ro/cars/new-models/s60-classic	/ro/cars/s60/	*
/ro/cars/new-models/s60-classic/accesorii	/ro/cars/s60/	*
/ro/cars/new-models/s60-classic/galerie	/ro/cars/s60/	*
/ro/cars/new-models/s60-classic/polestar	/ro/cars/s60/	*
/ro/cars/new-models/s60-classic/specificatii	/ro/cars/s60/	*
/ro/cars/new-models/s60-cross-country	/ro/cars/s60/	*
/ro/cars/new-models/s60/trims	/ro/cars/s60/	*
/ro/cars/new-models/s60/trims/inscription	/ro/cars/s60/	*
/ro/cars/new-models/s60/trims/momentum	/ro/cars/s60/	*
/ro/cars/new-models/s60/trims/r-design	/ro/cars/s60/	*
/ro/cars/new-models/s90  /ro/cars/s90/  *
/ro/cars/new-models/s90/trims	/ro/cars/s90/	*
/ro/cars/new-models/s90/trims/inscription	/ro/cars/s90/	*
/ro/cars/new-models/s90/trims/momentum	/ro/cars/s90/	*
/ro/cars/new-models/s90/trims/r-design	/ro/cars/s90/	*
/ro/cars/new-models/v60  /ro/cars/v60/  *
/ro/cars/new-models/v60-classic	/ro/cars/v60/	*
/ro/cars/new-models/v60-classic/accesorii	/ro/cars/v60/	*
/ro/cars/new-models/v60-classic/polestar	/ro/cars/v60/	*
/ro/cars/new-models/v60-classic/specificatii	/ro/cars/v60/	*
/ro/cars/new-models/v60-cross-country	/ro/cars/v60/  *
/ro/cars/new-models/v60-cross-country/accesorii	/ro/cars/v60/	*
/ro/cars/new-models/v60-cross-country/galerie	/ro/cars/v60/	*
/ro/cars/new-models/v60-cross-country/specificatii	/ro/cars/v60/	*
/ro/cars/new-models/v60/trims	/ro/cars/v60/	*
/ro/cars/new-models/v60/trims/cross-country	/ro/cars/v60-cross-country/	*
/ro/cars/new-models/v60/trims/inscription	/ro/cars/v60/	*
/ro/cars/new-models/v60/trims/momentum	/ro/cars/v60/	*
/ro/cars/new-models/v60/trims/r-design	/ro/cars/v60/	*
/ro/cars/new-models/v60cc  /ro/cars/v60-cross-country/  *
/ro/cars/new-models/v90/cross-country	/ro/cars/v90-cross-country/	*
/ro/cars/new-models/v90cc  /ro/cars/v90-cross-country/  *
/ro/cars/new-models/xc40  /ro/cars/xc40/  *
/ro/cars/new-models/xc40/echipari	/ro/cars/xc40/	*
/ro/cars/new-models/xc40/echipari/inscription	/ro/cars/xc40/	*
/ro/cars/new-models/xc40/echipari/momentum	/ro/cars/xc40/	*
/ro/cars/new-models/xc40/echipari/r-design	/ro/cars/xc40/	*
/ro/cars/new-models/xc60  /ro/cars/xc60/  *
/ro/cars/new-models/xc60/echipari	/ro/cars/xc60/	*
/ro/cars/new-models/xc60/echipari/inscription	/ro/cars/xc60/	*
/ro/cars/new-models/xc60/echipari/momentum	/ro/cars/xc60/	*
/ro/cars/new-models/xc60/echipari/polestar-engineered	/ro/cars/xc60/	*
/ro/cars/new-models/xc60/echipari/r-design	/ro/cars/xc60/	*
/ro/cars/new-models/xc90  /ro/cars/xc90/  *
/ro/cars/new-models/xc90/trim	/ro/cars/xc90/	*
/ro/cars/new-models/xc90/trim/inscription	/ro/cars/xc90/	*
/ro/cars/new-models/xc90/trim/momentum	/ro/cars/xc90/	*
/ro/cars/new-models/xc90/trim/r-design	/ro/cars/xc90/	*
/ar-sa/cars/new-models/s60  /ar-sa/v/cars/s60  *
/ar-sa/cars/new-models/s60/trims	/ar-sa/v/cars/s60	*
/ar-sa/cars/new-models/s60/trims/inscription	/ar-sa/v/cars/s60	*
/ar-sa/cars/new-models/s60/trims/r-design	/ar-sa/v/cars/s60	*
/ar-sa/cars/new-models/s90  /ar-sa/v/cars/s90  *
/ar-sa/cars/new-models/s90/trims	/ar-sa/v/cars/s90	*
/ar-sa/cars/new-models/s90/trims/inscription	/ar-sa/v/cars/s90  	*
/ar-sa/cars/new-models/s90/trims/momentum	/ar-sa/v/cars/s90	*
/ar-sa/cars/new-models/s90/trims/r-design	/ar-sa/v/cars/s90	*
/ar-sa/cars/new-models/v60  /ar-sa/v/cars/v60  *
/ar-sa/cars/new-models/v90cc  /ar-sa/v/cars/v90-cross-country  *
/ar-sa/cars/new-models/xc40  /ar-sa/v/cars/xc40  *
/ar-sa/cars/new-models/xc40/trims	/ar-sa/v/cars/xc40	*
/ar-sa/cars/new-models/xc40/trims/inscription	/ar-sa/v/cars/xc40	*
/ar-sa/cars/new-models/xc40/trims/momentum	/ar-sa/v/cars/xc40	*
/ar-sa/cars/new-models/xc40/trims/r-design	/ar-sa/v/cars/xc40	*
/ar-sa/cars/new-models/xc60  /ar-sa/v/cars/xc60  *
/ar-sa/cars/new-models/xc60/trims	/ar-sa/v/cars/xc60	*
/ar-sa/cars/new-models/xc60/trims/inscription	/ar-sa/v/cars/xc60	*
/ar-sa/cars/new-models/xc60/trims/momentum	/ar-sa/v/cars/xc60	*
/ar-sa/cars/new-models/xc60/trims/r-design	/ar-sa/v/cars/xc60	*
/ar-sa/cars/new-models/xc90 /ar-sa/v/cars/xc90  *
/ar-sa/cars/new-models/xc90/trims	/ar-sa/v/cars/xc90	*
/ar-sa/cars/new-models/xc90/trims/inscription	/ar-sa/v/cars/xc90	*
/ar-sa/cars/new-models/xc90/trims/momentum	/ar-sa/v/cars/xc90	*
/ar-sa/cars/new-models/xc90/trims/r-design	/ar-sa/v/cars/xc90	*
/en-sa/cars/dlbi%20offer%20request%20en	/en-sa/	*
/en-sa/cars/new-models/s60  /en-sa/v/cars/s60  *
/en-sa/cars/new-models/s60/trims	/en-sa/v/cars/s60	*
/en-sa/cars/new-models/s60/trims/inscription	/en-sa/v/cars/s60	*
/en-sa/cars/new-models/s60/trims/r-design	/en-sa/v/cars/s60	*
/en-sa/cars/new-models/s90  /en-sa/v/cars/s90  *
/en-sa/cars/new-models/s90/trims	/en-sa/v/cars/s90	*
/en-sa/cars/new-models/s90/trims/inscription	/en-sa/v/cars/s90	*
/en-sa/cars/new-models/s90/trims/momentum	/en-sa/v/cars/s90	*
/en-sa/cars/new-models/s90/trims/r-design	/en-sa/v/cars/s90	*
/en-sa/cars/new-models/v60  /en-sa/v/cars/v60  *
/en-sa/cars/new-models/v90cc  /en-sa/v/cars/v90-cross-country  *
/en-sa/cars/new-models/xc40  /en-sa/v/cars/xc40  *
/en-sa/cars/new-models/xc40/trims	/en-sa/v/cars/xc40	*
/en-sa/cars/new-models/xc40/trims/inscription	/en-sa/v/cars/xc40	*
/en-sa/cars/new-models/xc40/trims/momentum	/en-sa/v/cars/xc40	*
/en-sa/cars/new-models/xc40/trims/r-design	/en-sa/v/cars/xc40	*
/en-sa/cars/new-models/xc60  /en-sa/v/cars/xc60  *
/en-sa/cars/new-models/xc60/trims	/en-sa/v/cars/xc60	*
/en-sa/cars/new-models/xc60/trims/inscription	/en-sa/v/cars/xc60	*
/en-sa/cars/new-models/xc60/trims/momentum	/en-sa/v/cars/xc60	*
/en-sa/cars/new-models/xc60/trims/r-design	/en-sa/v/cars/xc60	*
/en-sa/cars/new-models/xc90  /en-sa/v/cars/xc90  *
/en-sa/cars/new-models/xc90/trims	/en-sa/v/cars/xc90	*
/en-sa/cars/new-models/xc90/trims/inscription	/en-sa/v/cars/xc90	*
/en-sa/cars/new-models/xc90/trims/momentum	/en-sa/v/cars/xc90	*
/en-sa/cars/new-models/xc90/trims/r-design	/en-sa/v/cars/xc90	*
/en-sa/cars/testdrive%20form%20en	/en-sa/	*
/al/cars/new-models/s90  /al/cars/s90/  *
/al/cars/new-models/s90/shprehjet	/al/cars/s90/	*
/al/cars/new-models/s90/shprehjet/inscription	/al/cars/s90/	*
/al/cars/new-models/s90/shprehjet/momentum	/al/cars/s90/	*
/al/cars/new-models/s90/shprehjet/r-design	/al/cars/s90/	*
/al/cars/new-models/v60  /al/cars/v60/  *
/al/cars/new-models/v60/shprehjet	/al/cars/v60/	*
/al/cars/new-models/v60/shprehjet/cross-country	/al/cars/v60-cross-country/	*
/al/cars/new-models/v60/shprehjet/inscription	/al/cars/v60/	*
/al/cars/new-models/v60/shprehjet/momentum	/al/cars/v60/	*
/al/cars/new-models/v60/shprehjet/r-design	/al/cars/v60/	*
/al/cars/new-models/v60cc  /al/cars/v60-cross-country/  *
/al/cars/new-models/v90	/al/cars/v90-cross-country/	*
/al/cars/new-models/v90/shprehjet	/al/cars/v90-cross-country/	*
/al/cars/new-models/v90/shprehjet/cross-country	/al/cars/v90-cross-country/	*
/al/cars/new-models/v90/shprehjet/momentum	/al/cars/v90-cross-country/	*
/al/cars/new-models/v90cc  /al/cars/v90-cross-country/  *
/al/cars/new-models/xc40  /al/v/cars/xc40  *
/al/cars/new-models/xc40/shprehjet	/al/v/cars/xc40	*
/al/cars/new-models/xc40/shprehjet/inscription	/al/v/cars/xc40	*
/al/cars/new-models/xc40/shprehjet/momentum	/al/v/cars/xc40	*
/al/cars/new-models/xc40/shprehjet/r-design	/al/v/cars/xc40	*
/al/cars/new-models/xc60  /al/v/cars/xc60  *
/al/cars/new-models/xc60/trims	/al/v/cars/xc60	*
/al/cars/new-models/xc60/trims/inscription	/al/v/cars/xc60	*
/al/cars/new-models/xc60/trims/momentum	/al/v/cars/xc60	*
/al/cars/new-models/xc60/trims/polestar-engineered	/al/v/cars/xc60	*
/al/cars/new-models/xc60/trims/r-design	/al/v/cars/xc60	*
/al/cars/new-models/xc90  /al/v/cars/xc90  *
/al/cars/new-models/xc90/expressions	/al/v/cars/xc90	*
/al/cars/new-models/xc90/expressions/inscription	/al/v/cars/xc90	*
/al/cars/new-models/xc90/expressions/momentum	/al/v/cars/xc90	*
/al/cars/new-models/xc90/expressions/r-design	/al/v/cars/xc90	*
/me/cars/elektricni-automobili	/me/v/cars/electric-cars	*
/me/cars/elektricni-automobili/plug-in-hibridi	/me/v/cars/plug-in-hybrids	*
/me/cars/new-models/s60  /me/cars/s60/  *
/me/cars/new-models/s60/varijante	/me/cars/s60/	*
/me/cars/new-models/s60/varijante/inscription	/me/cars/s60/	*
/me/cars/new-models/s60/varijante/r-design	/me/cars/s60/	*
/me/cars/new-models/s90  /me/cars/s90/  *
/me/cars/new-models/s90/varijante	/me/cars/s90/	*
/me/cars/new-models/s90/varijante/inscription	/me/cars/s90/	*
/me/cars/new-models/s90/varijante/momentum	/me/cars/s90/	*
/me/cars/new-models/s90/varijante/r-design	/me/cars/s90/	*
/me/cars/new-models/v60  /me/cars/v60/  *
/me/cars/new-models/v60/varijante	/me/cars/v60/	*
/me/cars/new-models/v60/varijante/cross-country	/me/cars/v60-cross-country/	*
/me/cars/new-models/v60/varijante/inscription	/me/cars/v60/	*
/me/cars/new-models/v60/varijante/momentum	/me/cars/v60/	*
/me/cars/new-models/v60/varijante/r-design	/me/cars/v60/	*
/me/cars/new-models/v60cc  /me/cars/v60-cross-country/  *
/me/cars/new-models/v90	/me/cars/v90-cross-country/	*
/me/cars/new-models/v90/varijante	/me/cars/v90-cross-country/	*
/me/cars/new-models/v90/varijante/cross-country	/me/cars/v90-cross-country/	*
/me/cars/new-models/v90/varijante/momentum	/me/cars/v90-cross-country/	*
/me/cars/new-models/v90cc  /me/cars/v90-cross-country/  *
/me/cars/new-models/xc40  /me/v/cars/xc40  *
/me/cars/new-models/xc40/varijante	/me/v/cars/xc40	*
/me/cars/new-models/xc40/varijante/inscription	/me/v/cars/xc40	*
/me/cars/new-models/xc40/varijante/momentum	/me/v/cars/xc40	*
/me/cars/new-models/xc40/varijante/r-design	/me/v/cars/xc40	*
/me/cars/new-models/xc60  /me/v/cars/xc60  *
/me/cars/new-models/xc60/varijante	/me/v/cars/xc60	*
/me/cars/new-models/xc60/varijante/inscription	/me/v/cars/xc60	*
/me/cars/new-models/xc60/varijante/momentum	/me/v/cars/xc60	*
/me/cars/new-models/xc60/varijante/polestar-engineered	/me/v/cars/xc60	*
/me/cars/new-models/xc60/varijante/r-design	/me/v/cars/xc60	*
/me/cars/new-models/xc90  /me/v/cars/xc90  *
/me/cars/new-models/xc90/varijante	/me/v/cars/xc90	*
/me/cars/new-models/xc90/varijante/inscription	/me/v/cars/xc90	*
/me/cars/new-models/xc90/varijante/momentum	/me/v/cars/xc90	*
/me/cars/new-models/xc90/varijante/r-design	/me/v/cars/xc90	*
/mk/cars/new-models/s60  /mk/cars/s60/  *
/mk/cars/new-models/s60/trims	/mk/cars/s60/	*
/mk/cars/new-models/s60/trims/inscription	/mk/cars/s60/	*
/mk/cars/new-models/s60/trims/r-design	/mk/cars/s60/	*
/mk/cars/new-models/s90  /mk/cars/s90/  *
/mk/cars/new-models/s90/trims	/mk/cars/s90/	*
/mk/cars/new-models/s90/trims/inscription	/mk/cars/s90/	*
/mk/cars/new-models/s90/trims/momentum	/mk/cars/s90/	*
/mk/cars/new-models/s90/trims/r-design	/mk/cars/s90/	*
/mk/cars/new-models/v60  /mk/cars/v60/  *
/mk/cars/new-models/v60/trims	/mk/cars/v60/	*
/mk/cars/new-models/v60/trims/cross-country	/mk/cars/v60-cross-country/	*
/mk/cars/new-models/v60/trims/inscription	/mk/cars/v60/	*
/mk/cars/new-models/v60/trims/momentum	/mk/cars/v60/	*
/mk/cars/new-models/v60/trims/r-design	/mk/cars/v60/	*
/mk/cars/new-models/v60cc  /mk/cars/v60-cross-country/  *
/mk/cars/new-models/v90	/mk/cars/v90-cross-country/	*
/mk/cars/new-models/v90/trims	/mk/cars/v90-cross-country/	*
/mk/cars/new-models/v90/trims/cross-country	/mk/cars/v90-cross-country/	*
/mk/cars/new-models/v90/trims/momentum	/mk/cars/v90-cross-country/	*
/mk/cars/new-models/v90cc  /mk/cars/v90-cross-country/  *
/mk/cars/new-models/xc40  /mk/v/cars/xc40  *
/mk/cars/new-models/xc40/trims	/mk/v/cars/xc40	*
/mk/cars/new-models/xc40/trims/inscription	/mk/v/cars/xc40	*
/mk/cars/new-models/xc40/trims/momentum	/mk/v/cars/xc40	*
/mk/cars/new-models/xc40/trims/r-design	/mk/v/cars/xc40	*
/mk/cars/new-models/xc60  /mk/v/cars/xc60  *
/mk/cars/new-models/xc60/trims	/mk/v/cars/xc60	*
/mk/cars/new-models/xc60/trims/inscription	/mk/v/cars/xc60	*
/mk/cars/new-models/xc60/trims/momentum	/mk/v/cars/xc60	*
/mk/cars/new-models/xc60/trims/polestar-engineered	/mk/v/cars/xc60	*
/mk/cars/new-models/xc60/trims/r-design	/mk/v/cars/xc60	*
/mk/cars/new-models/xc90  /mk/v/cars/xc90  *
/mk/cars/new-models/xc90/trims	/mk/v/cars/xc90	*
/mk/cars/new-models/xc90/trims/inscription	/mk/v/cars/xc90	*
/mk/cars/new-models/xc90/trims/momentum	/mk/v/cars/xc90	*
/mk/cars/new-models/xc90/trims/r-design	/mk/v/cars/xc90	*
/mt/cars/new-models/s60  /mt/v/cars/s60  *
/mt/cars/new-models/s60/trims	/mt/v/cars/s60	*
/mt/cars/new-models/s60/trims/r-design	/mt/v/cars/s60	*
/mt/cars/new-models/s90  /mt/v/cars/s90  *
/mt/cars/new-models/s90/trims	/mt/v/cars/s90	*
/mt/cars/new-models/s90/trims/inscription	/mt/v/cars/s90	*
/mt/cars/new-models/s90/trims/momentum	/mt/v/cars/s90	*
/mt/cars/new-models/s90/trims/r-design	/mt/v/cars/s90	*
/mt/cars/new-models/v60  /mt/v/cars/v60  *
/mt/cars/new-models/v60/trims	/mt/v/cars/v60	*
/mt/cars/new-models/v60/trims/inscription	/mt/v/cars/v60	*
/mt/cars/new-models/v60/trims/momentum	/mt/Cars/New-models/V60	*
/mt/cars/new-models/v60/trims/r-design	/mt/v/cars/v60	*
/mt/cars/new-models/xc40  /mt/cars/xc40/  *
/mt/cars/new-models/xc40/trims	/mt/cars/xc40/	*
/mt/cars/new-models/xc40/trims/inscription	/mt/cars/xc40/	*
/mt/cars/new-models/xc40/trims/momentum	/mt/cars/xc40/	*
/mt/cars/new-models/xc40/trims/r-design	/mt/cars/xc40/	*
/mt/cars/new-models/xc60  /mt/cars/xc60/  *
/mt/cars/new-models/xc60/trims	/mt/cars/xc60/	*
/mt/cars/new-models/xc60/trims/inscription	/mt/cars/xc60/	*
/mt/cars/new-models/xc60/trims/momentum	/mt/cars/xc60/	*
/mt/cars/new-models/xc60/trims/r-design	/mt/cars/xc60/	*
/mt/cars/new-models/xc90  /mt/cars/xc90/  *
/mt/cars/new-models/xc90/trims	/mt/cars/xc90/	*
/mt/cars/new-models/xc90/trims/inscription	/mt/cars/xc90/	*
/mt/cars/new-models/xc90/trims/momentum	/mt/cars/xc90/	*
/mt/cars/new-models/xc90/trims/r-design	/mt/cars/xc90/	*
/en-ae/cars/new-models/s60  /en-ae/cars/s60  *
/en-ae/cars/new-models/s90  /ar-ae/v/cars/s90  *
/ar-ae/cars/new-models/s60  /ar-ae/v/cars/s60  *
/ar-ae/cars/new-models/s90  /ar-ae/v/cars/s90  *
/ar-ae/cars/new-models/xc40  /ar-ae/v/cars/xc40  *
/ar-ae/cars/new-models/xc60  /ar-ae/v/cars/xc60  *
/ar-ae/cars/new-models/xc90  /ar-ae/v/cars/xc90  *
/en-ae/cars/new-models/xc40  /en-ae/v/cars/xc40  *
/en-ae/cars/new-models/xc60  /en-ae/cars/xc60/  *
/en-ae/cars/new-models/xc90  /en-ae/v/cars/xc90  *
##Expiry 2023-04-15
/jp/cars/48v-hybrid  /jp/v/cars/other-powertrains  *
/jp/cars/model-lineup  https://jp.volvocars.com/jp/cars/model-lineup/  *
/jp/cars/new-models/c40   /jp/v/cars/c40-electric  *
/jp/cars/new-models/s60  /jp/cars/s60-hybrid/  *
/jp/cars/new-models/s60/lineup  https://jp.volvocars.com/jp/cars/new-models/s60/lineup/   *
/jp/cars/new-models/s60/reviews  /jp/	*
/jp/cars/new-models/s60/reviews/ask-an-owner  /jp/	*
/jp/cars/new-models/s60/specifications	https://jp.volvocars.com/jp/cars/new-models/s60/lineup/	*
/jp/cars/new-models/s90/lineup	https://jp.volvocars.com/jp/cars/new-models/s90/lineup/  *
/jp/cars/new-models/v60  /jp/cars/v60-hybrid/  *
/jp/cars/new-models/v60-cross-country  /jp/v/cars/v60-cross-country  *
/jp/cars/new-models/v60-cross-country/lineup  https://jp.volvocars.com/jp/cars/new-models/v60-cross-country/lineup/  *
/jp/cars/new-models/v60-cross-country/reviews  /jp/	*
/jp/cars/new-models/v60-cross-country/reviews/ask-an-owner  /jp/	*
/jp/cars/new-models/v60-cross-country/specifications	https://jp.volvocars.com/jp/cars/new-models/v60-cross-country/lineup/	*
/jp/cars/new-models/v60/lineup  https://jp.volvocars.com/jp/cars/new-models/v60/lineup/  *
/jp/cars/new-models/v60/reviews  /jp/	*
/jp/cars/new-models/v60/reviews/ask-an-owner  /jp/	*
/jp/cars/new-models/v60/specifications	https://jp.volvocars.com/jp/cars/new-models/v60/lineup/	*
/jp/cars/new-models/v90  /jp/v/cars/v90-hybrid  *
/jp/cars/new-models/v90-cross-country  /jp/v/cars/v90-cross-country  *
/jp/cars/new-models/v90-cross-country/lineup  https://jp.volvocars.com/jp/cars/new-models/v90-cross-country/lineup/  *
/jp/cars/new-models/v90-cross-country/reviews  /jp/	*
/jp/cars/new-models/v90-cross-country/reviews/ask-an-owner  /jp/	*
/jp/cars/new-models/v90-cross-country/specifications	https://jp.volvocars.com/jp/cars/new-models/v90-cross-country/lineup/	*
/jp/cars/new-models/v90/lineup  https://jp.volvocars.com/jp/cars/new-models/v90/lineup/  *
/jp/cars/new-models/v90/reviews /jp/	*
/jp/cars/new-models/v90/reviews/ask-an-owner  /jp/	*
/jp/cars/new-models/v90/specifications	https://jp.volvocars.com/jp/cars/new-models/v90/lineup/	*
/jp/cars/new-models/xc40/lineup  https://jp.volvocars.com/jp/cars/new-models/xc40/lineup/  *
/jp/cars/new-models/xc40/reviews  /jp/	*
/jp/cars/new-models/xc40/reviews/ask-an-owner  /jp/	*
/jp/cars/new-models/xc40/specifications	https://jp.volvocars.com/jp/cars/new-models/xc40/lineup/	*
/jp/cars/new-models/xc60  /jp/cars/xc60-hybrid/  *
/jp/cars/new-models/xc60/lineup  https://jp.volvocars.com/jp/cars/new-models/xc60/lineup/  *
/jp/cars/new-models/xc60/reviews  /jp/	*
/jp/cars/new-models/xc60/reviews/ask-an-owner  /jp/	*
/jp/cars/new-models/xc60/specifications	https://jp.volvocars.com/jp/cars/new-models/xc60/lineup/	*
/jp/cars/new-models/xc90  /jp/cars/xc90-hybrid/  *
/jp/cars/new-models/xc90/lineup  https://jp.volvocars.com/jp/cars/new-models/xc90/lineup/  *
/jp/cars/new-models/xc90/reviews  /jp/	*
/jp/cars/new-models/xc90/reviews/ask-an-owner  /jp/	*
/jp/cars/new-models/xc90/specifications	https://jp.volvocars.com/jp/cars/new-models/xc90/lineup/	*
/jp/cars/phev  /jp/v/cars/recharge  *
/jp/cars/reviews /jp/	*
/ar-qa/cars/new-models/s60  /ar-qa/cars/s60/  *
/ar-qa/cars/new-models/s60/trims	/ar-qa/cars/s60/	*
/ar-qa/cars/new-models/s60/trims/inscription	/ar-qa/cars/s60/	*
/ar-qa/cars/new-models/s60/trims/r-design	/ar-qa/cars/s60/	*
/ar-qa/cars/new-models/s90  /ar-qa/cars/s90/  *
/ar-qa/cars/new-models/s90/trims	/ar-qa/cars/s90/	*
/ar-qa/cars/new-models/s90/trims/inscription	/ar-qa/cars/s90/	*
/ar-qa/cars/new-models/s90/trims/momentum	/ar-qa/cars/s90/	*
/ar-qa/cars/new-models/s90/trims/r-design	/ar-qa/cars/s90/	*
/ar-qa/cars/new-models/xc40  /ar-qa/v/cars/xc40  *
/ar-qa/cars/new-models/xc40/trims	/ar-qa/v/cars/xc40	*
/ar-qa/cars/new-models/xc40/trims/inscription	/ar-qa/v/cars/xc40	*
/ar-qa/cars/new-models/xc40/trims/momentum	/ar-qa/v/cars/xc40	*
/ar-qa/cars/new-models/xc40/trims/r-design	/ar-qa/v/cars/xc40	*
/ar-qa/cars/new-models/xc60  /ar-qa/cars/xc60/  *
/ar-qa/cars/new-models/xc60/trims	/ar-qa/cars/xc60/	*
/ar-qa/cars/new-models/xc60/trims/inscription	/ar-qa/cars/xc60/	*
/ar-qa/cars/new-models/xc60/trims/momentum	/ar-qa/cars/xc60/	*
/ar-qa/cars/new-models/xc60/trims/r-design	/ar-qa/cars/xc60/	*
/ar-qa/cars/new-models/xc90  /ar-qa/cars/xc90/  *
/ar-qa/cars/new-models/xc90/trims	/ar-qa/cars/xc90/	*
/ar-qa/cars/new-models/xc90/trims/inscription	/ar-qa/cars/xc90/	*
/ar-qa/cars/new-models/xc90/trims/momentum	/ar-qa/cars/xc90/	*
/ar-qa/cars/new-models/xc90/trims/r-design	/ar-qa/cars/xc90/	*
/au/cars  /au/build  *
/au/cars/category-pages	/au/l/model-lineup/	*
/au/cars/concept-cars	/au/v/our-story	*
/au/cars/concept-cars/concept-coupe	/au/v/our-story	*
/au/cars/concept-cars/concept-estate	/au/v/our-story	*
/au/cars/ebrochure	/au/l/model-lineup/	*
/au/cars/model-lineup/wagon	/au/l/model-lineup/	*
/au/cars/new-models/all-new-XC90/brand-campaign	/au/cars/xc90/	*
/au/cars/new-models/all-new-xc90	/au/cars/xc90/	*
/au/cars/new-models/all-new-xc90/accessories	/au/cars/xc90/	*
/au/cars/new-models/all-new-xc90/avicii	/au/cars/xc90/	*
/au/cars/new-models/all-new-xc90/design	/au/cars/xc90/	*
/au/cars/new-models/all-new-xc90/editions	/au/cars/xc90/	*
/au/cars/new-models/all-new-xc90/gallery	/au/cars/xc90/	*
/au/cars/new-models/all-new-xc90/specifications	/au/cars/xc90/	*
/au/cars/new-models/copy-of-xc40-full-pdp	/au/cars/xc40/	*
/au/cars/new-models/copy-of-xc90	/au/cars/xc90/	*
/au/cars/new-models/first-ever-xc40	/au/cars/xc40/	*
/au/cars/new-models/first-ever-xc40/meet-the-xc40	/au/cars/xc40/	*
/au/cars/new-models/first-ever-xc40/meet-the-xc40/terms	/au/cars/xc40/	*
/au/cars/new-models/first-ever-xc40a	/au/cars/xc40/	*
/au/cars/new-models/s60  /au/cars/s60/  *
/au/cars/new-models/s60/editions	/au/cars/s60/	*
/au/cars/new-models/s60/gallery	/au/cars/s60/	*
/au/cars/new-models/s60/keep-me-updated	/au/cars/s60/	*
/au/cars/new-models/s80	/au/cars/s60/	*
/au/cars/new-models/s80/accessories	/au/cars/s60/	*
/au/cars/new-models/s80/editions	/au/cars/s60/	*
/au/cars/new-models/s80/specifications	/au/cars/s60/	*
/au/cars/new-models/s90	/au/cars/s60/	*
/au/cars/new-models/s90/accessories	/au/cars/s60/	*
/au/cars/new-models/s90/build-your-own-s90	/au/cars/s60/	*
/au/cars/new-models/s90/connectivity	/au/cars/s60/	*
/au/cars/new-models/s90/connectivity-destination	/au/cars/s60/	*
/au/cars/new-models/s90/editions	/au/cars/s60/	*
/au/cars/new-models/s90/keep-me-updated	/au/cars/s60/	*
/au/cars/new-models/s90/keep-me-updated/thank-you	/au/cars/s60/	*
/au/cars/new-models/s90/power	/au/cars/s60/	*
/au/cars/new-models/s90/s90-open-doors-interactive	/au/cars/s60/	*
/au/cars/new-models/s90/safety	/au/l/model-lineup/	*
/au/cars/new-models/s90/specifications	/au/l/model-lineup/	*
/au/cars/new-models/the-new-xc60	/au/cars/xc60/	*
/au/cars/new-models/the-new-xc60/explore	/au/cars/xc60/  	*
/au/cars/new-models/the-new-xc60/explore/pleasure-for-your-senses	/au/cars/xc60/	*
/au/cars/new-models/the-new-xc60/explore/your-car-is-a-statement	/au/cars/xc60/	*
/au/cars/new-models/the-new-xc60/explore/your-life-made-easy	/au/cars/xc60/	*
/au/cars/new-models/the-new-xc60/keep-me-updated	/au/cars/xc60/	*
/au/cars/model-lineup	 /au/l/model-lineup/  *
/au/cars/new-models/v40	/au/l/model-lineup/	*
/au/cars/new-models/v40-cross-country	/au/l/model-lineup/	*
/au/cars/new-models/v40-cross-country/editions	/au/l/model-lineup/	*
/au/cars/new-models/v40-cross-country/gallery	/au/l/model-lineup/	*
/au/cars/new-models/v40-cross-country/specifications	 /au/l/model-lineup/  *
/au/cars/new-models/v40/accessories	 /au/l/model-lineup/  *
/au/cars/new-models/v40/build-your-own-v40	/au/build	*
/au/cars/new-models/v40/editions	/au/l/model-lineup/	*
/au/cars/new-models/v40/gallery	/au/l/model-lineup/	*
/au/cars/new-models/v40/knowing-the-details	/au/l/model-lineup/	*
/au/cars/new-models/v40/new-standard-page	/au/l/model-lineup/	*
/au/cars/new-models/v40/specifications	/au/l/model-lineup/	*
/au/cars/new-models/v60  /au/cars/v60-cross-country/  *
/au/cars/new-models/v60-cross-country	/au/cars/v60-cross-country/	*
/au/cars/new-models/v60-cross-country/editions	/au/cars/v60-cross-country/	*
/au/cars/new-models/v60-cross-country/gallery	/au/cars/v60-cross-country/	*
/au/cars/new-models/v60-cross-country/specifications	/au/cars/v60-cross-country/	*
/au/cars/new-models/v60/editions	/au/cars/v60-cross-country/	*
/au/cars/new-models/v60/editions/polestar	/au/cars/new-models/v60	*
/au/cars/new-models/v60/gallery	/au/cars/new-models/v60	*
/au/cars/new-models/v60/keep-me-updated	/au/cars/new-models/v60	*
/au/cars/new-models/v60/specifications	/au/cars/v60-cross-country/	*
/au/cars/new-models/v90-cross-country	/au/l/model-lineup/	*
/au/cars/new-models/v90-cross-country/accessories	/au/cars/new-models/v90-cross-country	*
/au/cars/new-models/v90-cross-country/book-a-test-drive	/au/l/model-lineup/	*
/au/cars/new-models/v90-cross-country/book-a-test-drive-v90cc	/au/l/model-lineup/	*
/au/cars/new-models/v90-cross-country/build	/au/build-your-own	*
/au/cars/new-models/v90-cross-country/build-your-own-v90-cc	/au/build-your-own	*
/au/cars/new-models/v90-cross-country/editions	/au/l/model-lineup/	*
/au/cars/new-models/v90-cross-country/specifications	/au/l/model-lineup/	*
/au/cars/new-models/xc40  /au/cars/xc40/  *
/au/cars/new-models/xc60  /au/cars/xc60/  *
/au/cars/new-models/xc60/accessories	/au/cars/xc60/	*
/au/cars/new-models/xc60/build-your-own-xc60	/au/build/xc60-hybrid	*
/au/cars/new-models/xc60/explore	/au/cars/xc60/	*
/au/cars/new-models/xc60/explore/pleasure-for-your-senses	/au/cars/xc60/	*
/au/cars/new-models/xc60/explore/your-car-is-a-statement	/au/cars/xc60/	*
/au/cars/new-models/xc60/explore/your-life-made-easy	/au/cars/xc60/	*
/au/cars/new-models/xc60/gallery	/au/cars/xc60/	*
/au/cars/new-models/xc60/keep-me-updated	/au/cars/xc60/	*
/au/cars/new-models/xc60/made-by-sweden	/au/cars/xc60/	*
/au/cars/new-models/xc60/make-parenting-look-easy	/au/cars/xc60/	*
/au/cars/new-models/xc60For	/au/cars/xc60/	*
/au/cars/new-models/xc70	/au/l/model-lineup/	*
/au/cars/new-models/xc90  /au/cars/xc90/  *
/au/cars/new-models/xc90-t8-twin-engine/xc90-t8-twin-engine	/au/cars/xc90/	*
/au/cars/new-models/xc90/Gallery	/au/cars/xc90/	*
/au/cars/new-models/xc90/INTELLIGENCE	/au/cars/xc90/	*
/au/cars/new-models/xc90/build-your-own-xc90	/au/build	*
/au/cars/new-models/xc90/design	/au/cars/xc90/	*
/au/cars/new-models/xc90/driveability	/au/cars/xc90/	*
/au/cars/new-models/xc90/excellence	/au/cars/xc90/	*
/au/cars/new-models/xc90/excellence/thank-you	/au/cars/xc90/	*
/au/cars/new-models/xc90/passenger	/au/cars/xc90/	*
/au/cars/new-models/xc90/safety	/au/cars/xc90/	*
/au/cars/new-models/xc90/technology	/au/cars/xc90/	*
/au/cars/new-models/xc90Check	/au/cars/xc90/	*
/au/cars/new-models/xc90_old1/design	/au/cars/xc90/	*
/au/cars/new-models/xc90_old1/safety	/au/cars/xc90/	*
/au/cars/new-models/xc90_old1fort	/au/cars/xc90/	*
/au/cars/new-models/xc90fort	/au/cars/xc90/	*
/au/cars/new-modelsing-soon	/au/cars/s60/	*
/au/cars/shake-the-world-gently	/au/v/our-story	*
/dk/cars/concept-cars  /dk/v/cars/concept-models  *
/co/cars/new-models/xc40  /co/v/cars/xc40  *
/co/cars/new-models/xc60  /co/v/cars/xc60  *
/co/cars/new-models/xc90  /co/v/cars/xc90  *
/cr/cars/new-models/xc40  /cr/v/cars/xc40  *
/cr/cars/new-models/xc60  /cr/v/cars/xc60  *
/cr/cars/new-models/xc90  /cr/v/cars/xc90  *
/dk/cars/kombi  /dk/v/cars/wagon  *
/dk/cars/new-models/den-nye-v90  /dk/v/cars/v90-hybrid  *
/dk/cars/new-models/den-nye-v90/v90cc-my21  /dk/v/cars/v90-cross-country  *
/dk/cars/new-models/s60  /dk/cars/s60-hybrid/  *
/dk/cars/new-models/s60/shop  /dk/v/cars/s60-hybrid/shop  *
/dk/cars/new-models/s90  /dk/v/cars/s90-hybrid  *
/dk/cars/new-models/s90/shop  /dk/v/cars/s90-hybrid/shop  *
/dk/cars/new-models/v60  /dk/cars/v60-hybrid/  *
/dk/cars/new-models/xc40  /dk/v/cars/xc40-hybrid  *
/dk/cars/new-models/xc40/xc40-recharge  /dk/v/cars/xc40-electric  *
/dk/cars/new-models/xc60  /dk/cars/xc60-hybrid/  *
/dk/cars/new-models/xc60/shop  /dk/v/cars/xc60-hybrid/shop  *
/dk/cars/new-models/xc90  /dk/v/cars/xc90-hybrid  *
/dk/cars/new-models/xc90/shop  /dk/v/cars/xc90-hybrid/shop  *
/dk/cars/other-powertrains  /dk/v/cars/other-powertrains  *
/dk/cars/polestar  /dk/l/Polestar-Performance-Optimering/  *
/dk/cars/privatleasing-2017	/dk/l/leasing/privatleasing/	*
/dk/cars/recharge  /dk/v/cars/recharge  *
/dk/cars/v60-cross-country  /dk/v/cars/v60-cross-country  *
/dk/cars/xc40-pure-electric  /dk/v/cars/xc40-electric  *
/dk/cars/fleet-sales  /dk/l/leasing/erhvervsleasing/  *
/gt/cars/new-models/xc40  /gt/v/cars/xc40-hybrid  *
/gt/cars/new-models/xc60  /gt/v/cars/xc60  *
/gt/cars/new-models/xc90  /gt/v/cars/xc90  *
/py/cars/new-models/el-nuevo-xc40  /py/v/cars/xc40  *
/py/cars/new-models/el-nuevo-xc60  /py/v/cars/xc60  *
/py/cars/new-models/el-nuevo-xc90  /py/v/cars/xc90  *
/pe/cars/nuevos-modelos/xc40  /pe/v/cars/xc40  *
/pe/cars/nuevos-modelos/xc40-t5-twin-engine  /pe/v/cars/xc40-hybrid  *
/pe/cars/nuevos-modelos/xc60  /pe/v/cars/xc60  *
/pe/cars/nuevos-modelos/xc60-t8-twin-engine  /pe/v/cars/xc60-hybrid  *
/pe/cars/nuevos-modelos/xc90  /pe/v/cars/xc90  *
/pe/cars/nuevos-modelos/xc90-t8-twin-engine  /pe/v/cars/xc90-hybrid  *
/pr/cars/new-models/s60  /pr/v/cars/sedan  *
/pr/cars/new-models/xc40  /pr/v/cars/xc40  *
/pr/cars/new-models/xc90  /pr/v/cars/xc90-hybrid  *
/uk/cars/business-sales/affinity/02VcN7  /uk/  *
/uk/cars/business-sales/affinity/2Su0Xw  /uk/  *
/uk/cars/business-sales/affinity/3pYv28  /uk/  *
/uk/cars/business-sales/affinity/4n6F2q  /uk/  *
/uk/cars/business-sales/affinity/5hK2z  /uk/  *
/uk/cars/business-sales/affinity/7Jt6LU  /uk/  *
/uk/cars/business-sales/affinity/7b5C9m  /uk/  *
/uk/cars/business-sales/affinity/85rpRt  /uk/  *
/uk/cars/business-sales/affinity/8YUb43  /uk/  *
/uk/cars/business-sales/affinity/97vCM3  /uk/  *
/uk/cars/business-sales/affinity/KS9b13  /uk/  *
/uk/cars/business-sales/affinity/P1df3B  /uk/  *
/uk/cars/business-sales/affinity/TMSGCA  /uk/  *
/uk/cars/business-sales/affinity/WR9cT9  /uk/  *
/uk/cars/business-sales/affinity/ch5n1c  /uk/  *
/uk/cars/business-sales/affinity/gctlnw  /uk/  *
/uk/cars/business-sales/contact/call-me-back	/uk/contact-request	*
/uk/cars/business-sales/finance	https://www.vcfsuk.co.uk/volvo/	*
/uk/cars/business-sales/finance-and-offers	https://www.vcfsuk.co.uk/volvo/	*
/uk/cars/business-sales/finance/advantage-plan	https://www.vcfsuk.co.uk/volvo/	*
/uk/cars/business-sales/finance/contract-hire	https://www.vcfsuk.co.uk/volvo/	*
/uk/cars/business-sales/finance/flexible-purchase-plan	https://www.vcfsuk.co.uk/volvo/	*
/uk/cars/business-sales/finance/purchase-plan	https://www.vcfsuk.co.uk/volvo/	*
/uk/cars/business-sales/new-xc60	/uk/l/offers/business/xc60/	*
/uk/cars/business-sales/news	/uk/cars/business-sales/vq	*
/uk/cars/business-sales/s60	/uk/Cars/Business-Sales/Business-Offers/S60	*
/uk/cars/business-sales/s90	/uk/l/offers/business/s90/	*
/uk/cars/business-sales/small-fleet	/uk/Cars/Business-Sales	*
/uk/cars/business-sales/tools	/uk/cars/business-sales/fleet-hub	*
/uk/cars/business-sales/v60	/uk/l/offers/business/v60/	*
/uk/cars/business-sales/v90	/uk/l/offers/business/v90/	*
/uk/cars/business-sales/vq-magazine	/uk/cars/business-sales/vq	*
/uk/cars/business-sales/vq-magazine/content	/uk/cars/business-sales/fleet-hub#!/id:356919/fleet-favourites/	*
/uk/cars/business-sales/vq-magazine/vq-magazine-90	/uk/cars/business-sales/vq	*
/uk/cars/business-sales/xc40	/uk/l/offers/business/xc40/	*
/uk/cars/business-sales/xc60	/uk/l/offers/business/xc60/	*
/uk/cars/business-sales/xc90	/uk/l/offers/business/xc90/	*
/uk/cars/car-configurator  /uk/build/  *
/uk/cars/model-lineup/estate-hatchback	/uk/v/cars/wagon	*
/uk/cars/new-models/V40/V40-Loyalty-Offer	/uk/l/used-cars/	*
/uk/cars/new-models/V40/VolvoV40	/uk/l/used-cars/	*
/uk/cars/new-models/V40/conduct-test	/uk/l/used-cars/	*
/uk/cars/new-models/V40/gallery	/uk/l/used-cars/	*
/uk/cars/new-models/V40/reevoo	/uk/l/used-cars/	*
/uk/cars/new-models/all-new-xc90/offers	/uk/l/offers/xc90/	*
/uk/cars/new-models/new-xc60/offers	/uk/l/offers/xc60/  	*
/uk/cars/new-models/new-xc60/offers/personal	/uk/l/offers/xc60/	*
/uk/cars/new-models/new-xc60/specifications	/uk/cars/xc60/	*
/uk/cars/new-models/s60-classic	/uk/cars/s60/	*
/uk/cars/new-models/s60-classic/brochure/business-brochure	/uk/l/pricelists/	*
/uk/cars/new-models/v40/accessories	/uk/l/used-cars/	*
/uk/cars/new-models/v40/brochure/business-brochure	/uk/l/pricelists/	*
/uk/cars/new-models/v40/brochure/personal-brochure	/uk/l/pricelists/	*
/uk/cars/new-models/v40/e-news	/uk/l/used-cars/	*
/uk/cars/new-models/v40/e-news/business	/uk/l/used-cars/	*
/uk/cars/new-models/v40/e-news/personal	/uk/l/used-cars/	*
/uk/cars/new-models/v40/editions	/uk/l/used-cars/	*
/uk/cars/new-models/v40/specifications/dimensions	/uk/l/used-cars/	*
/uk/cars/new-models/v40/specifications/engines	/uk/l/used-cars/	*
/uk/cars/new-models/v40/specifications/features	/uk/l/used-cars/	*
/uk/cars/new-models/v40/specifications/trims-comparison	/uk/l/used-cars/	*
/uk/cars/new-models/v40/variants	/uk/l/used-cars/	*
/uk/cars/new-models/v40/variants/cross-country	/uk/l/used-cars/	*
/uk/cars/new-models/v40/variants/inscription	/uk/l/used-cars/	*
/uk/cars/new-models/v40/variants/momentum	/uk/l/used-cars/	*
/uk/cars/new-models/v40/variants/r-design	/uk/l/used-cars/	*
/uk/cars/new-models/v60-classic	/uk/cars/v60/	*
/uk/cars/new-models/v60-classic/brochure/business-brochure	/uk/l/pricelists/	*
/uk/cars/new-models/v60-classic/offers	/uk/l/offers/v60/	*
/uk/cars/new-models/v60-twin-engine	/uk/cars/v60/	*
/uk/cars/new-models/v60/fuelmyimagination	/uk/cars/v60/	*
/uk/cars/new-models/v60/offers/personal	/uk/l/offers/v60/	*
/uk/cars/new-models/v90/the-guide	/uk/Support	*
/uk/cars/new-models/xc40/accessories	/uk/l/accessories/	*
/uk/cars/new-models/xc40/variants	/uk/cars/xc40/	*
/uk/cars/new-models/xc40/variants/inscription	/uk/cars/xc40/	*
/uk/cars/new-models/xc40/variants/momentum	/uk/cars/xc40/	*
/uk/cars/new-models/xc40/variants/r-design	/uk/cars/xc40/	*
/uk/cars/new-models/xc70	/uk/cars/v90/	*
/uk/cars/new-models/xc70/Test-Drive/Business	/uk/cars/v90/	*
/uk/cars/new-models/xc70/Test-Drive/Personal	/uk/cars/v90/	*
/uk/cars/new-models/xc70/accessories	/uk/cars/v90/	*
/uk/cars/new-models/xc70/brochure	/uk/cars/v90/	*
/uk/cars/new-models/xc70/brochure/brochure	/uk/cars/v90/	*
/uk/cars/new-models/xc70/e-news	/uk/cars/v90/	*
/uk/cars/new-models/xc70/gallery	/uk/cars/v90/	*
/uk/cars/new-models/xc70/offers	/uk/cars/v90/	*
/uk/cars/new-models/xc70/offers/business	/uk/cars/v90/	*
/uk/cars/new-models/xc70/offers/personal	/uk/cars/v90/	*
/uk/cars/new-models/xc70/reviews	/uk/cars/v90/	*
/uk/cars/new-models/xc70/specifications	/uk/cars/v90/	*
/uk/cars/new-models/xc70/test-drive	/uk/cars/v90/	*
/uk/cars/new-models/xc70/variants	/uk/cars/v90/	*
/uk/cars/new-models/xc90/brochure/business-brochure	/uk/l/pricelists/	*
/uk/cars/new-models/xc90/brochure/personal-brochure	/uk/l/pricelists/	*
/uk/cars/offers/offer-request	/uk/quote	*
/uk/cars/offers/personal	/uk/l/offers/	*
/uy/cars/new-models/xc90  /uy/v/cars/xc90-hybrid  *
/zh-cn/cars/new-models/all-new-xc90  /zh-cn/cars/xc90/  *
/zh-cn/cars/new-models/all-new-xc90/gallery	/zh-cn/cars/xc90/	*
/zh-cn/cars/new-models/s60  /zh-cn/cars/s60/  *
/zh-cn/cars/new-models/s60-recharge-t8  /zh-cn/v/cars/s60-hybrid  *
/zh-cn/cars/new-models/s60l-twin-engine	/zh-cn/cars/s60/	*
/zh-cn/cars/new-models/s60l-twin-engine/financing-offers	/zh-cn/cars/s60/	*
/zh-cn/cars/new-models/s60l-twin-engine/gpss-f	/zh-cn/cars/s60/	*
/zh-cn/cars/new-models/s60l-twin-engine/specifications	/zh-cn/cars/s60/	*
/zh-cn/cars/new-models/s90  /zh-cn/cars/s90/  *
/zh-cn/cars/new-models/s90/live	/zh-cn/cars/s90/	*
/zh-cn/cars/new-models/the-new-xc60  /zh-cn/cars/xc60/  *
/zh-cn/cars/new-models/v60  /zh-cn/cars/v60/  *
/zh-cn/cars/new-models/v60/accessories	/zh-cn/cars/v60/	*
/zh-cn/cars/new-models/v60/specifications	/zh-cn/cars/v60/	*
/zh-cn/cars/new-models/xc-classic	/zh-cn/cars/xc60/	*
/zh-cn/cars/new-models/xc40  /zh-cn/cars/xc40/  *
/zh-cn/cars/new-models/xc40-fashion	/zh-cn/cars/xc40/	*
/zh-cn/cars/new-models/xc40-music	/zh-cn/cars/xc40/	*
/zh-cn/cars/new-models/xc40-standard	/zh-cn/cars/xc40/	*
/zh-cn/cars/new-models/xc60	/zh-cn/cars/xc60/	*
/zh-cn/cars/new-models/xc60-recharge-t8  /zh-cn/v/cars/xc60-hybrid  *
/zh-cn/cars/new-models/xc60/financing-offers	/zh-cn/cars/xc60/	*
/zh-cn/cars/new-models/xc60/specifications	/zh-cn/cars/xc60/	*
/zh-cn/cars/new-models/xc90-recharge-t8  /zh-cn/v/cars/xc90-hybrid  *

##Expiry 2023-04-15
/kr/cars/model-lineup  /<market>/build/  *
/kr/cars/new-models/cross-country  /<market>/v/cars/v90-cross-country  *
/kr/cars/new-models/s60  /<market>/cars/s60/  *
/kr/cars/new-models/s90  /<market>/cars/s90  *
/kr/cars/new-models/the-new-volvo-cross-country  /<market>/v/cars/v60-cross-country  *
/kr/cars/new-models/the-new-volvo-xc40  /<market>/v/cars/xc40  *
/kr/cars/new-models/the-volvo-xc60  /<market>/v/cars/xc60  *
/kr/cars/new-models/xc90  /<market>/v/cars/xc90  *

##Expiry 2023-02-15
/en-vn/cars/new-models/s90  /<market>/v/cars/s90  *
/en-vn/cars/new-models/xc40  /<market>/v/cars/xc40  *
/en-vn/cars/new-models/xc60  /<market>/v/cars/xc60  *
/en-vn/cars/new-models/xc90  /<market>/v/cars/xc90  *
/kh/cars/new-models/s90  /<market>/v/cars/s90  *
/kh/cars/new-models/xc40  /<market>/v/cars/xc40  *
/kh/cars/new-models/xc60  /<market>/v/cars/xc60  *
/kh/cars/new-models/xc90  /<market>/v/cars/xc90  *
/my/cars/new-models/all-new-xc90	/my/cars/xc90/	*
/my/cars/new-models/s60  /my/cars/s60-hybrid/  *
/my/cars/new-models/xc40  /<market>/v/cars/xc40  *
/my/cars/new-models/xc60  /my/cars/xc60/  *
/my/cars/new-models/xc90  /<market>/cars/xc90  *
/en-th/cars/new-models/s60-21  /<market>/v/cars/s60-hybrid  *
/en-th/cars/new-models/s90-21  /<market>/v/cars/s90-hybrid  *
/en-th/cars/new-models/v60-21  /<market>/v/cars/v60-hybrid  *
/en-th/cars/new-models/xc40-21  /<market>/v/cars/xc40-hybrid  *
/en-th/cars/new-models/xc60-21  /<market>/v/cars/xc60-hybrid  *
/en-th/cars/new-models/xc90-21  /<market>/v/cars/xc90-hybrid  *
/th-th/cars/new-models/s60-21  /<market>/v/cars/s60-hybrid  *
/th-th/cars/new-models/s90-21  /<market>/v/cars/s90-hybrid  *
/th-th/cars/new-models/v60-21  /<market>/v/cars/v60-hybrid  *
/th-th/cars/new-models/xc40-21  /<market>/v/cars/xc40-hybrid  *
/th-th/cars/new-models/xc60-21  /<market>/v/cars/xc60-hybrid  *
/th-th/cars/new-models/xc90-21  /<market>/v/cars/xc90-hybrid  *
##Expiry 2023-02-15
/ph/cars/new-models/s90  /<market>/cars/s90  *
/ph/cars/new-models/xc40  /<market>/cars/xc40  *
/ph/cars/new-models/xc60  /<market>/cars/xc60  *
/ph/cars/new-models/xc90  /<market>/cars/xc90  *
##Expiry 2023-04-15
/ro-md/cars/gama-de-modele/s90  /ro-md/v/cars/s90  *
/ro-md/cars/gama-de-modele/s90/trims	/ru-md/cars/s90/	*
/ro-md/cars/gama-de-modele/s90/trims/momentum	/ru-md/cars/s90/	*
/ro-md/cars/gama-de-modele/s90/trims/r-design	/ru-md/cars/s90/	*
/ro-md/cars/gama-de-modele/v90/trims	/ro-md/cars/v90-cross-country/	*
/ro-md/cars/gama-de-modele/v90/trims/cross-country	/ro-md/cars/v90-cross-country/	*
/ro-md/cars/gama-de-modele/v90cc  /ro-md/cars/v90-cross-country/  *
/ro-md/cars/gama-de-modele/xc40  /ro-md/cars/xc40/  *
/ro-md/cars/gama-de-modele/xc40/inscription	/ro-md/cars/xc40/	*
/ro-md/cars/gama-de-modele/xc40/momentum	/ro-md/cars/xc40/	*
/ro-md/cars/gama-de-modele/xc40/r-design	/ro-md/cars/xc40/	*
/ro-md/cars/gama-de-modele/xc40/trims	/ro-md/cars/xc40/	*
/ro-md/cars/gama-de-modele/xc60  /ro-md/cars/xc60/  *
/ro-md/cars/gama-de-modele/xc90  /ro-md/cars/xc90/  *
/ro-md/cars/gama-de-modele/xc90/trims	/ro-md/cars/xc90/	*
/ro-md/cars/gama-de-modele/xc90/trims/inscription	/ro-md/cars/xc90/	*
/ro-md/cars/gama-de-modele/xc90/trims/momentum	/ro-md/cars/xc90/	*
/ro-md/cars/gama-de-modele/xc90/trims/r-design	/ro-md/cars/xc90/	*
/ro-md/cars/new-models/xc60	/ro-md/cars/xc60/	*
/ro-md/cars/new-models/xc60/trims	/ro-md/cars/xc60/	*
/ro-md/cars/new-models/xc60/trims/inscription	/ro-md/cars/xc60/	*
/ro-md/cars/new-models/xc60/trims/momentum	/ro-md/cars/xc60/	*
/ro-md/cars/new-models/xc60/trims/r-design	/ro-md/cars/xc60/	*

/ru/cars/armoured-cars  /<market>/  *
/ru-md/cars/hybrid-cars	/ru-md/v/cars/recharge	*
/ru-md/cars/hybrid-cars/plug-in-hybrids	/ru-md/v/cars/plug-in-hybrids	*
/ru-md/cars/new-models/s90  /ru-md/cars/s90/  *
/ru-md/cars/new-models/v90	/ru-md/cars/v90-cross-country/	*
/ru-md/cars/new-models/v90/accessories	/ru-md/cars/v90-cross-country/	*
/ru-md/cars/new-models/v90/trims	/ru-md/cars/v90-cross-country/	*
/ru-md/cars/new-models/v90/trims/cross-country	/ru-md/cars/v90-cross-country/	*
/ru-md/cars/new-models/v90cc  /ru-md/cars/v90-cross-country/  *
/ru-md/cars/new-models/xc40  /ru-md/cars/xc40/  *
/ru-md/cars/new-models/xc40/trims	/ru-md/cars/xc40/	*
/ru-md/cars/new-models/xc40/trims/inscription	/ru-md/cars/xc40/	*
/ru-md/cars/new-models/xc40/trims/momentum	/ru-md/cars/xc40/	*
/ru-md/cars/new-models/xc40/trims/r-design	/ru-md/cars/xc40/	*
/ru-md/cars/new-models/xc60  /ru-md/cars/xc60/  *
/ru-md/cars/new-models/xc60/inscription	/ru-md/cars/xc60/	*
/ru-md/cars/new-models/xc60/momentum	/ru-md/cars/xc60/	*
/ru-md/cars/new-models/xc60/r-design	/ru-md/cars/xc60/	*
/ru-md/cars/new-models/xc60/trims	/ru-md/cars/xc60/	*
/ru-md/cars/new-models/xc90  /ru-md/cars/xc90/  *
/ru-md/cars/new-models/xc90/trims	/ru-md/cars/xc90/	*
/ru-md/cars/new-models/xc90/trims/inscription	/ru-md/cars/xc90/	*
/ru-md/cars/new-models/xc90/trims/momentum	/ru-md/cars/xc90/	*
/ru-md/cars/new-models/xc90/trims/r-design	/ru-md/cars/xc90/	*



## coches namespace
##Expiry 2023-04-05
/es/coches/etiquetas-medioambientales  /es/l/coches/etiquetas-medioambientales/  *
/es/coches/etiquetas-medioambientales/etiqueta-b  /es/l/coches/etiquetas-medioambientales/etiqueta-b/  *
/es/coches/etiquetas-medioambientales/etiqueta-c  /es/l/coches/etiquetas-medioambientales/etiqueta-c/  *
/es/coches/etiquetas-medioambientales/etiqueta-cero  /es/l/coches/etiquetas-medioambientales/etiqueta-cero/  *
/es/coches/etiquetas-medioambientales/etiqueta-eco  /es/l/coches/etiquetas-medioambientales/etiqueta-eco/  *

##Expiry 2023-03-15
/es/coches/concept-cars/c26	 /es/v/cars/concept-models  *
/es/coches/nuevos-modelos/s60-2018	 /es/support/car/s60/17w17  *
/es/coches/nuevos-modelos/s60/amp/	 /es/cars/s60/  *
/es/coches/nuevos-modelos/s60/historias	 /es/cars/s60/features/  *
/es/coches/nuevos-modelos/s60/versiones/polestar-engineered	 /es/cars/s60/  *
/es/coches/nuevos-modelos/s60/versiones/r-design	 /es/cars/s60/  *
/es/coches/nuevos-modelos/v60/oferta	 /es/l/coches/ofertas-promociones/s60/  *
/es/coches/nuevos-modelos/v90/oferta  /es/l/coches/ofertas-promociones/s90/  *
/es/coches/nuevos-modelos/xc40/hibrido/amp/	  /es/cars/xc40-hybrid/  *
/es/coches/nuevos-modelos/xc40/volvo-online	  /es/v/cars/xc40-hybrid/shop/  *
/es/coches/nuevos-modelos/xc60/hibrido/formulario-xc60-recharge	 /es/build/xc60-hybrid  *
/es/coches/nuevos-modelos/xc60/versiones/momentum	 /es/cars/xc60/  *
/es/coches/nuevos-modelos/xc90/oferta	 /es/l/coches/ofertas-promociones/xc90/  *
/es/coches/nuevos-modelos/xc90/versiones	 /es/cars/xc90/  *
/es/coches/nuevos-modelos/xc90/versiones/inscription	 /es/cars/xc90/  *
/es/coches/nuevos-modelos/xc90/versiones/momentum	 /es/cars/xc90/  *
/es/coches/nuevosmodelos/v60/precioyespecificaciones/features 	/es/l/coches/ofertas-promociones/v60/  *
/es/coches/ofertas-promociones/financiacion-0/xc60	 /es/l/servicios/financiacion/coche/  *
/es/coches/ofertas-promociones/formulario-wffs-oferta-xc90	 /es/l/coches/ofertas-promociones/  *
/es/coches/ofertas-promociones/xc40	 /es/l/coches/ofertas-promociones/xc40/  *
/es/coches/precios	 /es/l/coches/precios/  *
/es/coches/suv/hibridos	 /es/v/cars/suv  *
/es/coches/XC40-Recharge/el-futuro-es-electrico	 /es/cars/xc40-hybrid/  *
/es/coches/nuevos-modelos/s60/prueba		/es/cars/s60/		*
/es/coches/nuevos-modelos/xc40/quedate-en-casa		/es/cars/xc40/		*
/es/coches/ofertas-promociones/formulario-dct-oferta-v60		/es/l/coches/ofertas-promociones/v60/		*
/es/coches/ofertas-promociones/volvo-v60		/es/l/coches/ofertas-promociones/v60/		*
/es/coches/ofertas-promociones/volvo-xc90		/es/l/coches/ofertas-promociones/xc90/		*
/es/coches/futureofdriving	 /es/v/safety/highlights  *
/es/coches/nuevos-modelos/s60/precio-y-especificaciones/features	 /es/cars/s60/  *
/es/coches/nuevos-modelos/s60/versiones	 /es/cars/s60/  *
/es/coches/nuevos-modelos/s60/versiones/inscription	 /es/cars/s60/	 *
/es/coches/nuevos-modelos/s90/prueba	 /es/cars/s90/  *
/es/coches/nuevos-modelos/s90/versiones  /es/cars/s90/  *	
/es/coches/nuevos-modelos/s90/versiones/business-plus	 /es/cars/s90/  *	
/es/coches/nuevos-modelos/s90/versiones/inscription	 /es/cars/s90/  *
/es/coches/nuevos-modelos/s90/versiones/r-design 	/es/cars/s90/  *
/es/coches/nuevos-modelos/v60/prueba	 /es/cars/v60/  *	
/es/coches/nuevos-modelos/v60/versiones 	/es/cars/v60/  *
/es/coches/nuevos-modelos/v60/versiones/inscription	 /es/cars/v60/  *	
/es/coches/nuevos-modelos/v60/versiones/momentum	 /es/cars/v60/  *	
/es/coches/nuevos-modelos/v90/prueba	 /es/cars/v90/  *	
/es/coches/nuevos-modelos/v90/versiones	 /es/cars/v90/  *
/es/coches/nuevos-modelos/v90/versiones/business-plus	 /es/cars/v90/  *	
/es/coches/nuevos-modelos/v90/versiones/inscription	 /es/cars/v90/  *
/es/coches/nuevos-modelos/v90/versiones/r-design	 /es/cars/v90/  *	
/es/coches/nuevos-modelos/xc40/car-sharing	 /es/cars/xc40/  *
/es/coches/nuevos-modelos/xc40/prueba	 /es/cars/xc40/  *
/es/coches/nuevos-modelos/xc40/versiones	 /es/cars/xc40/  *
/es/coches/nuevos-modelos/xc40/versiones/inscription	 /es/cars/xc40/  *	
/es/coches/nuevos-modelos/xc40/versiones/momentum	 /es/cars/xc40/	 *
/es/coches/nuevos-modelos/xc40/versiones/r-design	 /es/cars/xc40/	 *
/es/coches/nuevos-modelos/xc60/prueba	 /es/cars/xc60/  *
/es/coches/nuevos-modelos/xc90/prueba	 /es/cars/xc90/  *
/es/coches/nuevos-modelos/xc90/versiones/r-design	 /es/cars/xc90/	 *
/es/coches/suv/7-plazas	 /es/v/cars/suv	 *
/es/comparativa-coches  /es/v/cars/suv  *
/es/coches/nuevos-modelos/v60/precio-y-especificaciones/features		/es/cars/v60/		*					
/es/coches/nuevos-modelos/xc40/precio-y-especificaciones/features		/es/cars/xc40/	*						
/es/coches/nuevos-modelos/xc60/precio-y-especificaciones/features		/es/cars/xc60/	*
/es/coches/segunda-mano-ocasion  /es/l/coches/segunda-mano-ocasion/  *
/es/coches/concept-cars  /es/v/car-safety/eva-initiative-cars-equally-safe  *
/es/coches/concept-cars/360c  /es/v/cars/concept-models/360c  *
/es/coches/concept-cars/ambiente-interior  /es/v/cars/concept-models/ambience  *
/es/coches/concept-cars/xc-coupe  /es/v/cars/concept-models/concept-xc-coupe  *
/es/coches/concept-cars/estate  /es/v/cars/concept-models/concept-estate  *
/es/coches/concept-cars/coupe  /es/v/cars/concept-models/concept-coupe  *
/es/coches/concept-cars/concept-40  /es/v/cars/concept-models/concept-40  *
/es/coches/Polestar-Engineered	/es/l/servicios/extras/accesorios-coche/optimizacion-polestar/	*
/es/coches/familiares  /es/v/cars/wagon  *
/es/coches/formulario-registro-xc40-electrico	/es/keep-me-updated	*
/es/coches/nuevos-modelos/s60  /es/cars/s60/  *
/es/coches/nuevos-modelos/s60-2019	/es/cars/s60/	*
/es/coches/nuevos-modelos/s60/accesorios	/es/v/buy/accessories	*
/es/coches/nuevos-modelos/s60/hibrido  /<market>/v/cars/s60-hybrid  *
/es/coches/nuevos-modelos/s60/mas-informacion	/es/cars/s60/	*
/es/coches/nuevos-modelos/s60/mas-informacion/thank-you	/es/cars/s60/	*
/es/coches/nuevos-modelos/s60/opiniones   /<market>/v/cars/s60  *
/es/coches/nuevos-modelos/s60/precio-y-especificaciones  /es/cars/s60/  *
/es/coches/nuevos-modelos/s60/precio-y-especificaciones/comparativa-versiones  /<market>/v/cars/s60  *
/es/coches/nuevos-modelos/s60/precio-y-especificaciones/medidas-dimensiones  /<market>/v/cars/s60  *
/es/coches/nuevos-modelos/s60/precio-y-especificaciones/motores  /<market>/v/cars/s60  *
/es/coches/nuevos-modelos/s90  /es/cars/s90/  *
/es/coches/nuevos-modelos/s90-2018	/es/cars/s90/	*
/es/coches/nuevos-modelos/s90-2018/accesorios-2018	/es/v/buy/accessories	*
/es/coches/nuevos-modelos/s90-2018/precio-y-especificaciones-2018	/es/cars/s90/	*
/es/coches/nuevos-modelos/s90-2018/precio-y-especificaciones-2018/Features-2018	/es/cars/s90/	*
/es/coches/nuevos-modelos/s90-2018/precio-y-especificaciones-2018/comparativa-versiones-2018	/es/cars/s90/	*
/es/coches/nuevos-modelos/s90-2018/precio-y-especificaciones-2018/medidas-dimensiones-2018	/es/cars/s90/	*
/es/coches/nuevos-modelos/s90-2018/precio-y-especificaciones-2018/motores-2018	/es/cars/s90/	*
/es/coches/nuevos-modelos/s90-2018/versiones-2018	/es/cars/s90/	*
/es/coches/nuevos-modelos/s90-2018/versiones-2018/Momentum-2018	/es/cars/s90/	*
/es/coches/nuevos-modelos/s90-2018/versiones-2018/inscription-2018	/es/cars/s90/	*
/es/coches/nuevos-modelos/s90-2018/versiones-2018/r-design-2018	/es/cars/s90/	*
/es/coches/nuevos-modelos/s90-hibrido	/es/cars/s90-hybrid/	*
/es/coches/nuevos-modelos/s90/accesorios	/es/v/buy/accessories  *
/es/coches/nuevos-modelos/s90/deportivo-rdesign  /es/cars/s90/  *
/es/coches/nuevos-modelos/s90/ficha-tecnica	/es/cars/s90/	*
/es/coches/nuevos-modelos/s90/hibrido  /es/cars/s90-hybrid/  *
/es/coches/nuevos-modelos/s90/opiniones   /<market>/v/cars/s90  *
/es/coches/nuevos-modelos/s90/precio-y-especificaciones  /es/cars/s90/  *
/es/coches/nuevos-modelos/s90/precio-y-especificaciones-old	/es/cars/s90/	*
/es/coches/nuevos-modelos/s90/precio-y-especificaciones/comparativa-versiones  /es/cars/s90/  *
/es/coches/nuevos-modelos/s90/precio-y-especificaciones/medidas-dimensiones  /es/cars/s90/  *
/es/coches/nuevos-modelos/s90/precio-y-especificaciones/motores  /es/cars/s90/  *
/es/coches/nuevos-modelos/v40	/es/v/cars/wagon	*
/es/coches/nuevos-modelos/v40-cross-country  /es/v/cars/wagon  *
/es/coches/nuevos-modelos/v40-cross-country/Oferta	/es/v/cars/wagon	*
/es/coches/nuevos-modelos/v40-cross-country/accesorios	/es/v/cars/wagon	*
/es/coches/nuevos-modelos/v40-cross-country/ficha-tecnica	/es/v/cars/wagon	*
/es/coches/nuevos-modelos/v40-cross-country/fotos-interior-exterior	/es/v/cars/wagon	*
/es/coches/nuevos-modelos/v40-cross-country/precio-y-especificaciones	/es/v/cars/wagon	*
/es/coches/nuevos-modelos/v40-cross-country/prueba	/es/v/cars/wagon	*
/es/coches/nuevos-modelos/v40-cross-country/versiones	/es/v/cars/wagon	*
/es/coches/nuevos-modelos/v40/Cross-Country	/es/v/cars/wagon	*
/es/coches/nuevos-modelos/v40/accesorios	/es/v/cars/wagon	*
/es/coches/nuevos-modelos/v40/ficha-tecnica	/es/v/cars/wagon	*
/es/coches/nuevos-modelos/v40/fotos-interior-exterior	/es/v/cars/wagon	*
/es/coches/nuevos-modelos/v40/oferta	/es/v/cars/wagon	*
/es/coches/nuevos-modelos/v40/opiniones	/es/v/cars/wagon	*
/es/coches/nuevos-modelos/v40/precio-y-especificaciones	/es/v/cars/wagon	*
/es/coches/nuevos-modelos/v40/precio-y-especificaciones/Features	/es/v/cars/wagon	*
/es/coches/nuevos-modelos/v40/precio-y-especificaciones/comparativa-versiones	/es/v/cars/wagon	*
/es/coches/nuevos-modelos/v40/precio-y-especificaciones/medidas-dimensiones	/es/v/cars/wagon	*
/es/coches/nuevos-modelos/v40/precio-y-especificaciones/motores	/es/v/cars/wagon	*
/es/coches/nuevos-modelos/v40/prueba	/es/v/cars/wagon	*
/es/coches/nuevos-modelos/v40/versiones	/es/v/cars/wagon	*
/es/coches/nuevos-modelos/v40/versiones/Inscription_old	/es/v/cars/wagon	*
/es/coches/nuevos-modelos/v40/versiones/Momentum_old	/es/v/cars/wagon	*
/es/coches/nuevos-modelos/v40/versiones/cross-country	/es/v/cars/wagon	*
/es/coches/nuevos-modelos/v40/versiones/momentum	/es/v/cars/wagon	*
/es/coches/nuevos-modelos/v40/versiones/r-design	/es/v/cars/wagon	*
/es/coches/nuevos-modelos/v60  /es/cars/v60/  *
/es/coches/nuevos-modelos/v60-2017	/es/cars/v60/	*
/es/coches/nuevos-modelos/v60-2017/accesorios	/es/cars/v60/	*
/es/coches/nuevos-modelos/v60-2017/hibrido	/es/cars/v60/	*
/es/coches/nuevos-modelos/v60-2017/precio-y-especificaciones	/es/cars/v60/	*
/es/coches/nuevos-modelos/v60-2017/prueba	/es/cars/v60/	*
/es/coches/nuevos-modelos/v60-2017/versiones	/es/cars/v60/	*
/es/coches/nuevos-modelos/v60-2017/versiones/cross-country	/es/cars/v60/	*
/es/coches/nuevos-modelos/v60-2017/versiones/polestar	/es/cars/v60/	*
/es/coches/nuevos-modelos/v60-2017/versiones/r-design	/es/cars/v60/	*
/es/coches/nuevos-modelos/v60-cross-country-2017	/es/cars/v60/	*
/es/coches/nuevos-modelos/v60-cross-country-2017/precio-y-especificaciones	/es/cars/v60/	*
/es/coches/nuevos-modelos/v60-cross-country-2017/prueba	/es/cars/v60/	*
/es/coches/nuevos-modelos/v60-hibrido	/es/cars/v60-hybrid/	*
/es/coches/nuevos-modelos/v60/accesorios	/es/v/buy/accessories	*
/es/coches/nuevos-modelos/v60/care-by-volvo	/es/l/servicios/financiacion/coche/care-by-volvo/	*
/es/coches/nuevos-modelos/v60/ficha-tecnica	/es/cars/v60/	*
/es/coches/nuevos-modelos/v60/hibrido  /es/cars/v60-hybrid/  *
/es/coches/nuevos-modelos/v60/mas-informacion	/es/cars/v60/	*
/es/coches/nuevos-modelos/v60/opiniones   /<market>/v/cars/v60  *
/es/coches/nuevos-modelos/v60/polestar	/es/cars/v60/	*
/es/coches/nuevos-modelos/v60/precio-y-especificaciones  /es/cars/v60/  *
/es/coches/nuevos-modelos/v60/precio-y-especificaciones-old	/es/cars/v60/	*
/es/coches/nuevos-modelos/v60/precio-y-especificaciones/comparativa-versiones  /<market>/v/cars/v60  *
/es/coches/nuevos-modelos/v60/precio-y-especificaciones/medidas-dimensiones  /<market>/v/cars/v60  *
/es/coches/nuevos-modelos/v60/precio-y-especificaciones/motores  /<market>/v/cars/v60  *
/es/coches/nuevos-modelos/v60/thank-you	/es/cars/v60/	*
/es/coches/nuevos-modelos/v60/versiones/cross-country  /es/cars/v60-cross-country/  *
/es/coches/nuevos-modelos/v60/versiones/r-design	/es/cars/v60/	*
/es/coches/nuevos-modelos/v60/versiones2	/es/cars/v60/	*
/es/coches/nuevos-modelos/v90  /es/cars/v90/  *
/es/coches/nuevos-modelos/v90-2018	/es/cars/v90/	*
/es/coches/nuevos-modelos/v90-2018/precio-y-especificaciones	/es/cars/v90/	*
/es/coches/nuevos-modelos/v90-2018/precio-y-especificaciones/Features	/es/cars/v90/	*
/es/coches/nuevos-modelos/v90-2018/precio-y-especificaciones/comparativa-versiones	/es/cars/v90/	*
/es/coches/nuevos-modelos/v90-2018/precio-y-especificaciones/medidas-dimensiones	/es/cars/v90/	*
/es/coches/nuevos-modelos/v90-2018/precio-y-especificaciones/motores	/es/cars/v90/	*
/es/coches/nuevos-modelos/v90-2018/versiones	/es/cars/v90/	*
/es/coches/nuevos-modelos/v90-2018/versiones/Momentum	/es/cars/v90/	*
/es/coches/nuevos-modelos/v90-2018/versiones/Volvo-Ocean-Race	/es/cars/v90/	*
/es/coches/nuevos-modelos/v90-2018/versiones/Volvo-Ocean-Race_old	/es/cars/v90/	*
/es/coches/nuevos-modelos/v90-2018/versiones/cross-country	/es/cars/v90-cross-country/	*
/es/coches/nuevos-modelos/v90-2018/versiones/inscription	/es/cars/v90/	*
/es/coches/nuevos-modelos/v90-2018/versiones/r-design	/es/cars/v90/	*
/es/coches/nuevos-modelos/v90-cross-country  /es/cars/v90-cross-country/  *
/es/coches/nuevos-modelos/v90-cross-country/%5Bnotmeurl%5D	/es/cars/v90/	*
/es/coches/nuevos-modelos/v90-cross-country/Mas-informacion	/es/cars/v90-cross-country/	*
/es/coches/nuevos-modelos/v90-cross-country/accesorios	/es/cars/v90-cross-country/	*
/es/coches/nuevos-modelos/v90-cross-country/catalogo	/es/cars/v90-cross-country/	*
/es/coches/nuevos-modelos/v90-cross-country/precio-y-especificaciones	/es/cars/v90-cross-country/	*
/es/coches/nuevos-modelos/v90-cross-country/prueba	/es/cars/v90-cross-country/	*
/es/coches/nuevos-modelos/v90-cross-country/todocamino	/es/cars/v90-cross-country/	*
/es/coches/nuevos-modelos/v90-hibrido	/es/cars/v90-hybrid/	*
/es/coches/nuevos-modelos/v90/%5Bnotmeurl%5D	/es/cars/v90/	*
/es/coches/nuevos-modelos/v90/accesorios	/es/v/buy/accessories	*
/es/coches/nuevos-modelos/v90/coches-suecos/s90	/es/cars/s90/	*
/es/coches/nuevos-modelos/v90/coches-suecos/v90	/es/cars/v90/	*
/es/coches/nuevos-modelos/v90/coches-suecos/xc90	/es/cars/xc90/	*
/es/coches/nuevos-modelos/v90/cross-country	/es/cars/v90-cross-country/	*
/es/coches/nuevos-modelos/v90/deportivo-rdesign	/es/cars/v90/	*
/es/coches/nuevos-modelos/v90/ficha-tecnica	/es/cars/v90/	*
/es/coches/nuevos-modelos/v90/hibrido  /es/cars/v90-hybrid/  *
/es/coches/nuevos-modelos/v90/mas-informacion	/es/cars/v90/	*
/es/coches/nuevos-modelos/v90/opiniones   /<market>/v/cars/v90  *
/es/coches/nuevos-modelos/v90/precio-y-especificaciones  /es/cars/v90/  *
/es/coches/nuevos-modelos/v90/precio-y-especificaciones-old	/es/cars/v90/	*
/es/coches/nuevos-modelos/v90/precio-y-especificaciones/comparativa-versiones  /es/cars/v90/  *
/es/coches/nuevos-modelos/v90/precio-y-especificaciones/medidas-dimensiones  /es/cars/v90/  *
/es/coches/nuevos-modelos/v90/precio-y-especificaciones/motores  /es/cars/v90/  *
/es/coches/nuevos-modelos/v90/versiones/cross-country  /es/cars/v90-cross-country/  *
/es/coches/nuevos-modelos/v90/versiones2	/es/cars/v90/	*
/es/coches/nuevos-modelos/xc40  /es/cars/xc40/  *
/es/coches/nuevos-modelos/xc40-2019	/es/cars/xc40/	*
/es/coches/nuevos-modelos/xc40/accesorios	/es/v/buy/accessories	*
/es/coches/nuevos-modelos/xc40/care-by-volvo	/es/l/servicios/financiacion/coche/care-by-volvo/	*
/es/coches/nuevos-modelos/xc40/hibrido  /<market>/v/cars/xc40-hybrid  *
/es/coches/nuevos-modelos/xc40/opiniones   /<market>/v/cars/xc40  *
/es/coches/nuevos-modelos/xc40/precio-y-especificaciones  /<market>/v/cars/xc40  *
/es/coches/nuevos-modelos/xc40/precio-y-especificaciones/comparativa-versiones  /<market>/v/cars/xc40  *
/es/coches/nuevos-modelos/xc40/precio-y-especificaciones/medidas-dimensiones  /<market>/v/cars/xc40  *
/es/coches/nuevos-modelos/xc40/precio-y-especificaciones/motores  /<market>/v/cars/xc40  *
/es/coches/nuevos-modelos/xc60  /es/cars/xc60/  *
/es/coches/nuevos-modelos/xc60-hibrido	/es/cars/xc60-hybrid/	*
/es/coches/nuevos-modelos/xc60/Mas-informacion	/es/	*
/es/coches/nuevos-modelos/xc60/accesorios	/es/v/buy/accessories	*
/es/coches/nuevos-modelos/xc60/arrive-like-never-before	/es/cars/xc60/	*
/es/coches/nuevos-modelos/xc60/care-by-volvo	/es/l/servicios/financiacion/coche/care-by-volvo/  *
/es/coches/nuevos-modelos/xc60/hibrido  /es/cars/xc60-hybrid/  *
/es/coches/nuevos-modelos/xc60/opiniones   /<market>/v/cars/xc60  *
/es/coches/nuevos-modelos/xc60/precio-y-especificaciones  /<market>/v/cars/xc60  *
/es/coches/nuevos-modelos/xc60/precio-y-especificaciones/comparativa-versiones  /<market>/v/cars/xc60  *
/es/coches/nuevos-modelos/xc60/precio-y-especificaciones/medidas-dimensiones  /<market>/v/cars/xc60  *
/es/coches/nuevos-modelos/xc60/precio-y-especificaciones/motores  /<market>/v/cars/xc60  *
/es/coches/nuevos-modelos/xc60/xc60-embracing-the-future	/es/cars/xc60/	*
/es/coches/nuevos-modelos/xc60/xc60-moments	/es/cars/xc60/	*
/es/coches/nuevos-modelos/xc90  /es/cars/xc90/  *
/es/coches/nuevos-modelos/xc90-hibrido	/es/cars/xc90-hybrid/	*
/es/coches/nuevos-modelos/xc90/%5Bnotmeurl%5D	/es/cars/xc90/	*
/es/coches/nuevos-modelos/xc90/accesorios	/es/v/buy/accessories	*
/es/coches/nuevos-modelos/xc90/accessorios	/es/v/buy/accessories	*
/es/coches/nuevos-modelos/xc90/hibrido  /es/cars/xc90-hybrid/  *
/es/coches/nuevos-modelos/xc90/opiniones   /<market>/v/cars/xc90  *
/es/coches/nuevos-modelos/xc90/precio-y-especificaciones  /es/cars/xc90/  *
/es/coches/nuevos-modelos/xc90/precio-y-especificaciones/comparativa-versiones  /<market>/v/cars/xc90  *
/es/coches/nuevos-modelos/xc90/precio-y-especificaciones/medidas-dimensiones  /<market>/v/cars/xc90  *
/es/coches/nuevos-modelos/xc90/precio-y-especificaciones/motores  /<market>/v/cars/xc90  *
/es/coches/ofertas-promociones  /es/l/coches/ofertas-promociones/	*
/es/coches/ofertas-promociones/c40 /es/l/coches/ofertas-promociones/c40/	*
/es/coches/ofertas-promociones/financiacion-0/xc40  /es/l/coches/ofertas-promociones/  *
/es/coches/ofertas-promociones/financiacion-0/xc90  /es/l/coches/ofertas-promociones/  *
/es/coches/ofertas-promociones/formulario-dct-oferta-v40-cross-country	/es/l/coches/ofertas-promociones/	*
/es/coches/ofertas-promociones/formulario-dct-oferta-v40-r-design	/es/l/coches/ofertas-promociones/	*
/es/coches/ofertas-promociones/formulario-wffs-oferta-v40	/es/l/coches/ofertas-promociones/	*
/es/coches/ofertas-promociones/financiacion-0/  /es/l/coches/ofertas-promociones/  *
/es/coches/ofertas-promociones/s60	/es/cars/s60/	*
/es/coches/ofertas-promociones/s90  /es/l/coches/ofertas-promociones/s90/	*
/es/coches/ofertas-promociones/v40	/es/l/coches/ofertas-promociones/	*
/es/coches/ofertas-promociones/v40-cross-country	/es/l/coches/ofertas-promociones/	*
/es/coches/ofertas-promociones/v40-r-design	/es/l/coches/ofertas-promociones/	*
/es/coches/ofertas-promociones/v60	/es/cars/v60/	*
/es/coches/ofertas-promociones/v60-cross-country	/es/cars/v60-cross-country/	*
/es/coches/ofertas-promociones/v60-cross-country-2  /es/l/coches/ofertas-promociones/v60-cross-country-2/	*
/es/coches/ofertas-promociones/v90  /es/l/coches/ofertas-promociones/v90/	*
/es/coches/ofertas-promociones/v90-cross-country  /es/l/coches/ofertas-promociones/v90-cross-country/	*
/es/coches/ofertas-promociones/volvo-xc60  /es/l/coches/ofertas-promociones/volvo-xc60/	*
/es/coches/ofertas-promociones/xc40-electrico-oferta  /es/l/coches/ofertas-promociones/xc40-electrico-oferta/	*
/es/coches/ofertas-promociones/xc40-t4-recharge  /es/l/coches/ofertas-promociones/xc40-t4-recharge/	*
/es/coches/ofertas-promociones/xc60	/es/l/coches/ofertas-promociones/	*
/es/coches/ofertas-promociones/xc90  /es/l/coches/ofertas-promociones/xc90/	*
/es/coches/sedan  /es/v/cars/sedan  *
/es/coches/sedan-berlina	/es/v/cars/sedan	*
/es/coches/suv  /<market>/v/cars/suv  *
/es/coches/suv/renting-suv	/es/l/servicios/financiacion/coche/renting/suv/	*
/es/coches/xc40-pure-electric  /<market>/v/cars/xc40-electric  *

## modeles namespace
##expiry 2023-04-15
/fr-ch/modeles/nous-modeles/s90  /fr-ch/cars/s90/		*
/fr-ch/modeles/nous-modeles/v90  /fr-ch/cars/v90/		*
/fr-ch/modeles/nous-modeles/xc40-full-pdp  /fr-ch/cars/xc40/		*
/fr-ch/modeles/nous-modeles/xc90  /fr-ch/cars/xc90/		*
/fr-ch/modeles/nous-modeles/s60/caractéristiques-techniques		/fr-ch/cars/s60/		*
/fr-ch/modeles/nous-modeles/s60/caractéristiques-techniques/dimensions		/fr-ch/cars/s60/		*
/fr-ch/modeles/nous-modeles/s60/caractéristiques-techniques/moteurs		/fr-ch/cars/s60/		*
/fr-ch/modeles/nous-modeles/s90/caractéristiques-techniques		/fr-ch/cars/s90/	*
/fr-ch/modeles/nous-modeles/s90/caractéristiques-techniques/comparaison-des-éditions		/fr-ch/cars/s90/			*
/fr-ch/modeles/nous-modeles/s90/caractéristiques-techniques/moteurs		/fr-ch/cars/s90/	*
/fr-ch/modeles/nous-modeles/v90/caractéristiques-techniques		/fr-ch/cars/v90/		*
/fr-ch/modeles/nous-modeles/v90/caractéristiques-techniques/comparaison-des-éditions		/fr-ch/cars/v90/	*
/fr-ch/modeles/nous-modeles/v90/caractéristiques-techniques/dimensions		/fr-ch/cars/v90/		*
/fr-ch/modeles/nous-modeles/v90/caractéristiques-techniques/moteurs		/fr-ch/cars/v90/	*
/fr-ch/modeles/nous-modeles/volvo-xc60/caractéristiques-techniques		/fr-ch/cars/xc60/	*
/fr-ch/modeles/nous-modeles/volvo-xc60/caractéristiques-techniques/dimensions		/fr-ch/cars/xc60/		*
/fr-ch/modeles/nous-modeles/volvo-xc60/caractéristiques-techniques/moteurs		/fr-ch/cars/xc60/		*
/fr-ch/modeles/nous-modeles/xc40/caractéristiques-techniques		/fr-ch/cars/xc40/		*
/fr-ch/modeles/nous-modeles/xc40/caractéristiques-techniques/comparaison-des-éditions		/fr-ch/cars/xc40/		*
/fr-ch/modeles/nous-modeles/xc40/caractéristiques-techniques/dimensions		/fr-ch/cars/xc40/	*						
/fr-ch/modeles/nous-modeles/xc40/caractéristiques-techniques/moteurs		/fr-ch/cars/xc40/	*						
/fr-ch/modeles/nous-modeles/xc90/caractéristiques-techniques		/fr-ch/cars/xc90/			*				
/fr-ch/modeles/nous-modeles/xc90/caractéristiques-techniques/comparaison-des-éditions		/fr-ch/cars/xc90/ *
/fr-ch/modeles/nous-modeles/xc90/caractéristiques-techniques/dimensions		/fr-ch/cars/xc90/		*
/fr-ch/modeles/nous-modeles/xc90/caractéristiques-techniques/highlights		/fr-ch/cars/xc90/		*					
/fr-ch/modeles/nous-modeles/xc90/caractéristiques-techniques/moteurs		/fr-ch/cars/xc90/	 *
##expiry 2023-01-30
/lu/modeles/gamme	/lu/  *
/lu/modeles/made-by-people	/lu/  *
/lu/modeles-recharge	/lu/v/cars/electric-cars  *
/fr-ch/modeles/concept-cars /fr-ch/v/cars/concept-models  *
/lu/modeles/concept-cars	/lu/v/cars/concept-models  *
/lu/modeles/concept-cars/360c /lu/v/cars/concept-models/360c  *
/lu/modeles/concept-cars/concept-40	/lu/v/cars/concept-models/concept-40  *
/lu/modeles/concept-cars/concept-coupe	/lu/v/cars/concept-models/concept-coupe  *
/lu/modeles/concept-cars/concept-estate /lu/v/cars/concept-models/concept-estate  *
/lu/modeles/concept-cars/concept-xc-coupe	/lu/v/cars/concept-models/concept-xc-coupe  *
/fr-ch/modeles/concept-cars/360c	/fr-ch/v/cars/concept-models/360c  *
/fr-ch/modeles/concept-cars/concept-26  /fr-ch/v/cars/concept-models  *
/fr-ch/modeles/concept-cars/concept-cars-preview  /fr-ch/v/cars/concept-models  *
/fr-ch/modeles/concept-cars/ambience-interior	/fr-ch/v/cars/concept-models/ambience  *
/fr-ch/modeles/concept-cars/concept-40	 /fr-ch/v/cars/concept-models/concept-40  *
/fr-ch/modeles/concept-cars/concept-coupé	/fr-ch/v/cars/concept-models/concept-coupe  *
/fr-ch/modeles/concept-cars/concept-estate	/fr-ch/v/cars/concept-models/concept-estate  *
/fr-ch/modeles/concept-cars/concept-xc-coupé	/fr-ch/v/cars/concept-models/concept-xc-coupe  *

/fr-ch/modeles/cross-country  /fr-ch/v/cars/wagon *
/fr-ch/modeles/nous-modeles/s60  /fr-ch/v/cars/s60-hybrid *
/fr-ch/modeles/nous-modeles/s60-twin-engine  /fr-ch/v/cars/s60-hybrid  *
/fr-ch/modeles/nous-modeles/s60/caract%C3%A9ristiques-techniques/comparaison-des-%C3%A9ditions  /fr-ch/v/cars/s60-hybrid  *
/fr-ch/modeles/nous-modeles/s60/downloads  /fr-ch/v/cars/s60-hybrid/shop  *
/fr-ch/modeles/nous-modeles/s60/shop  /fr-ch/v/cars/s60-hybrid/shop  *
/fr-ch/modeles/nous-modeles/s90-twin-engine  /fr-ch/v/cars/s90-hybrid  *
/fr-ch/modeles/nous-modeles/s90/caract%C3%A9ristiques-techniques/comparaison-des-%C3%A9ditions  /fr-ch/v/cars/s90-hybrid  *
/fr-ch/modeles/nous-modeles/s90/downloads  /fr-ch/v/cars/s90-hybrid/shop  *
/fr-ch/modeles/nous-modeles/s90/editionen	/fr-ch/cars/s90/	*
/fr-ch/modeles/nous-modeles/s90/inscription	/fr-ch/cars/s90/	*
/fr-ch/modeles/nous-modeles/s90/momentum	/fr-ch/cars/s90/	*
/fr-ch/modeles/nous-modeles/s90/r-design	/fr-ch/cars/s90/	*
/fr-ch/modeles/nous-modeles/v60-twin-engine  /fr-ch/v/cars/v60-hybrid  *
/fr-ch/modeles/nous-modeles/v90/caract%C3%A9ristiques-techniques/comparaison-des-%C3%A9ditions  /fr-ch/v/cars/v90-hybrid  *
/fr-ch/modeles/nous-modeles/v90/downloads  /fr-ch/v/cars/v90-hybrid/shop  *
/fr-ch/modeles/nous-modeles/v90/editionen	/fr-ch/cars/v90/	*
/fr-ch/modeles/nous-modeles/v90/editionen/inscription	/fr-ch/cars/v90/	*
/fr-ch/modeles/nous-modeles/v90/editionen/momentum	/fr-ch/cars/v90/	*
/fr-ch/modeles/nous-modeles/v90/editionen/r-design	/fr-ch/cars/v90/	*
/fr-ch/modeles/nous-modeles/v90/editionen/v90-cross-country-volvo-ocean-race	/fr-ch/cars/v90/	*
/fr-ch/modeles/nous-modeles/v90/made-by-sweden  /fr-ch/v/cars/v90-hybrid  *
/fr-ch/modeles/nous-modeles/volvo-s60-twin-engine  /fr-ch/v/cars/s60-hybrid  *
/fr-ch/modeles/nous-modeles/volvo-s90  /fr-ch/v/cars/s90-hybrid *
/fr-ch/modeles/nous-modeles/volvo-s90-twin-engine  /fr-ch/v/cars/s90-hybrid  *
/fr-ch/modeles/nous-modeles/volvo-s90/shop  /fr-ch/v/cars/s90-hybrid/shop  *
/fr-ch/modeles/nous-modeles/volvo-v60  /fr-ch/cars/v60-hybrid/ *
/fr-ch/modeles/nous-modeles/volvo-v60/caracteristiques-techniques/comparaison-des-%C3%A9ditions  /fr-ch/v/cars/v60-hybrid  *
/fr-ch/modeles/nous-modeles/volvo-v60/cross-country  /fr-ch/v/cars/v60-cross-country  *
/fr-ch/modeles/nous-modeles/volvo-v60/cross-country/shop  /fr-ch/v/cars/v60-cross-country/shop  *
/fr-ch/modeles/nous-modeles/volvo-v60/downloads  /fr-ch/v/cars/v60-hybrid/shop  *
/fr-ch/modeles/nous-modeles/volvo-v60/shop  /fr-ch/v/cars/v60-hybrid/shop *
/fr-ch/modeles/nous-modeles/volvo-v90  /fr-ch/v/cars/v90-hybrid *
/fr-ch/modeles/nous-modeles/volvo-v90-twin-engine  /fr-ch/v/cars/v90-hybrid  *
/fr-ch/modeles/nous-modeles/volvo-v90/cross-country  /fr-ch/v/cars/v90-cross-country  *
/fr-ch/modeles/nous-modeles/volvo-v90/cross-country/shop  /fr-ch/v/cars/v90-cross-country/shop  *
/fr-ch/modeles/nous-modeles/volvo-v90/shop  /fr-ch/v/cars/v90-hybrid/shop *
/fr-ch/modeles/nous-modeles/volvo-xc60  /fr-ch/cars/xc60-hybrid/  *
/fr-ch/modeles/nous-modeles/volvo-xc60-twin-engine  /fr-ch/v/cars/xc60-hybrid  *
/fr-ch/modeles/nous-modeles/volvo-xc60/caract%C3%A9ristiques-techniques/comparaison-des-%C3%A9ditions  /fr-ch/v/cars/xc60-hybrid  *
/fr-ch/modeles/nous-modeles/volvo-xc60/downloads  /fr-ch/v/cars/xc60-hybrid/shop  *
/fr-ch/modeles/nous-modeles/volvo-xc60/moments  /fr-ch/v/cars/xc60-hybrid  *
/fr-ch/modeles/nous-modeles/volvo-xc60/shop  /fr-ch/v/cars/xc60-hybrid/shop  *
/fr-ch/modeles/nous-modeles/volvo-xc60/stories  /fr-ch/v/cars/xc60-hybrid  *
/fr-ch/modeles/nous-modeles/volvo-xc60/stories/audio  /fr-ch/v/cars/xc60-hybrid  *
/fr-ch/modeles/nous-modeles/volvo-xc60/stories/cleanzone  /fr-ch/v/cars/xc60-hybrid  *
/fr-ch/modeles/nous-modeles/volvo-xc60/stories/conduite-autonome  /fr-ch/v/cars/xc60-hybrid  *
/fr-ch/modeles/nous-modeles/volvo-xc60/stories/conduite-dynamique  /fr-ch/v/cars/xc60-hybrid  *
/fr-ch/modeles/nous-modeles/volvo-xc60/stories/effortless-ownership  /fr-ch/v/cars/xc60-hybrid  *
/fr-ch/modeles/nous-modeles/volvo-xc60/stories/experience-utilisateur-intuitive  /fr-ch/v/cars/xc60-hybrid  *
/fr-ch/modeles/nous-modeles/volvo-xc60/stories/personnalisation  /fr-ch/v/cars/xc60-hybrid  *
/fr-ch/modeles/nous-modeles/volvo-xc60/stories/philosophie-de-design-scandinave  /fr-ch/v/cars/xc60-hybrid  *
/fr-ch/modeles/nous-modeles/volvo-xc60/stories/powered-tailgate  /fr-ch/v/cars/xc60-hybrid  *
/fr-ch/modeles/nous-modeles/volvo-xc60/stories/puissance-sans-compromis  /fr-ch/v/cars/xc60-hybrid  *
/fr-ch/modeles/nous-modeles/volvo-xc60/stories/une-technologie-utile  /fr-ch/v/cars/xc60-hybrid  *
/fr-ch/modeles/nous-modeles/volvo-xc90  /fr-ch/cars/xc90-hybrid/  *
/fr-ch/modeles/nous-modeles/volvo-xc90/shop  /fr-ch/v/cars/xc90-hybrid/shop  *
/fr-ch/modeles/nous-modeles/xc40  /fr-ch/  *
/fr-ch/modeles/nous-modeles/xc40-twin-engine  /fr-ch/v/cars/xc40-hybrid  *
/fr-ch/modeles/nous-modeles/xc40-twin-engine/mettez-vous-au-courant  /fr-ch/v/cars/xc40-hybrid  *
/fr-ch/modeles/nous-modeles/xc40/360-tour  /fr-ch/v/cars/xc40-hybrid  *
/fr-ch/modeles/nous-modeles/xc40/caract%C3%A9ristiques-techniques/comparaison-des-%C3%A9ditions  /fr-ch/v/cars/xc40-hybrid  *
/fr-ch/modeles/nous-modeles/xc40/editionen	/fr-ch/	*
/fr-ch/modeles/nous-modeles/xc40/editionen/inscription	/fr-ch/	*
/fr-ch/modeles/nous-modeles/xc40/editionen/momentum	/fr-ch/	*
/fr-ch/modeles/nous-modeles/xc40/editionen/r-design	/fr-ch/	*
/fr-ch/modeles/nous-modeles/xc40/premi%C3%A8re-du-genre  /fr-ch/v/cars/xc40-hybrid  *
/fr-ch/modeles/nous-modeles/xc60/editionen	/fr-ch/cars/xc60-hybrid/	*
/fr-ch/modeles/nous-modeles/xc60/editionen/inscription	/fr-ch/cars/xc60-hybrid/	*
/fr-ch/modeles/nous-modeles/xc60/editionen/momentum	/fr-ch/cars/xc60-hybrid/	*
/fr-ch/modeles/nous-modeles/xc60/editionen/polestar-engineered	/fr-ch/cars/xc60-hybrid/	*
/fr-ch/modeles/nous-modeles/xc60/editionen/r-design	/fr-ch/cars/xc60-hybrid/	*
/fr-ch/modeles/nous-modeles/xc90-twin-engine  /fr-ch/v/cars/xc90-hybrid  *
/fr-ch/modeles/nous-modeles/xc90/caract%C3%A9ristiques-techniques/comparaison-des-%C3%A9ditions  /fr-ch/v/cars/xc90-hybrid  *
/fr-ch/modeles/nous-modeles/xc90/downloads  /fr-ch/v/cars/xc90-hybrid/shop  *
/fr-ch/modeles/nous-modeles/xc90/gamme	/fr-ch/cars/xc90/	*
/fr-ch/modeles/nous-modeles/xc90/gamme/inscription	/fr-ch/cars/xc90/	*
/fr-ch/modeles/nous-modeles/xc90/gamme/momentum	/fr-ch/cars/xc90/	*
/fr-ch/modeles/nous-modeles/xc90/gamme/r-design	/fr-ch/cars/xc90/	*
/fr-ch/modeles/other-powertrains /fr-ch/v/cars/other-powertrains  *
/fr-ch/modeles/recharge /fr-ch/v/cars/recharge *
/fr-ch/modeles/s60  /fr-ch/v/cars/s60  *
/fr-ch/modeles/s60/shop  /fr-ch/v/cars/s60/shop  *
/fr-ch/modeles/s90  /fr-ch/v/cars/s90  *
/fr-ch/modeles/s90/shop  /fr-ch/v/cars/s90/shop  *
/fr-ch/modeles/sedan  /fr-ch/v/cars/sedan  *
/fr-ch/modeles/service-flotte/autorité/véhicules-blindés  /fr-ch/special-vehicles/	*
/fr-ch/modeles/suv  /fr-ch/v/cars/suv  *
/fr-ch/modeles/v60  /fr-ch/v/cars/v60  *
/fr-ch/modeles/v60/shop  /fr-ch/v/cars/v60/shop  *
/fr-ch/modeles/v90  /fr-ch/v/cars/v90  *
/fr-ch/modeles/v90/shop  /fr-ch/v/cars/v90/shop  *
/fr-ch/modeles/xc40  /fr-ch/v/cars/xc40  *
/fr-ch/modeles/xc40-pure-electric  /fr-ch/v/cars/xc40-electric  * 
/fr-ch/modeles/xc40/shop  /fr-ch/v/cars/xc40/shop  *
/fr-ch/modeles/xc60  /fr-ch/v/cars/xc60  *
/fr-ch/modeles/xc60/shop  /fr-ch/v/cars/xc60/shop  *
/fr-ch/modeles/xc90  /fr-ch/v/cars/xc90  *
/fr-ch/modeles/xc90/shop  /fr-ch/v/cars/xc90/shop  *
/lu/modeles/gamme/v40-cross-country  /lu/l/modeles/  *
/lu/modeles/historique/heritage-models  /lu/v/discover/heritage-car-models *
/lu/modeles/historique/heritage-models/0-ov4  /lu/v/discover/heritage-car-models#öv4 *
/lu/modeles/historique/heritage-models/1-pv4  /lu/v/discover/heritage-car-models#pv4 *
/lu/modeles/historique/heritage-models/10-pv444  /lu/v/discover/heritage-car-models#pv444 *
/lu/modeles/historique/heritage-models/11-pv831-4  /lu/v/discover/heritage-car-models#pv831-4 *
/lu/modeles/historique/heritage-models/12-pv445-pv445-duett  /lu/v/discover/heritage-car-models#pv445-pv445-duett *
/lu/modeles/historique/heritage-models/13-caravan-trailer  /lu/v/discover/heritage-car-models#caravane-remorque *
/lu/modeles/historique/heritage-models/14-sport-p1900  /lu/v/discover/heritage-car-models#sport-p1900 *
/lu/modeles/historique/heritage-models/15-pv544  /lu/v/discover/heritage-car-models#pv544 *
/lu/modeles/historique/heritage-models/16-p1200-p120-amazon  /lu/v/discover/heritage-car-models#p1200-p120-amazon *
/lu/modeles/historique/heritage-models/17-p210-duett  /lu/v/discover/heritage-car-models#p210-duett *
/lu/modeles/historique/heritage-models/18-p130-amazon-2-d  /lu/v/discover/heritage-car-models#p130-amazon-2-d *
/lu/modeles/historique/heritage-models/19-p1800-1800  /lu/v/discover/heritage-car-models#p1800-1800 *
/lu/modeles/historique/heritage-models/2-pv651  /lu/v/discover/heritage-car-models#pv651 *
/lu/modeles/historique/heritage-models/20-p220-amazon-estate  /lu/v/discover/heritage-car-models#p220-amazon-break *
/lu/modeles/historique/heritage-models/21-144  /lu/v/discover/heritage-car-models#144 *
/lu/modeles/historique/heritage-models/22-142  /lu/v/discover/heritage-car-models#142 *
/lu/modeles/historique/heritage-models/23-145  /lu/v/discover/heritage-car-models#145 *
/lu/modeles/historique/heritage-models/24-164  /lu/v/discover/heritage-car-models#164 *
/lu/modeles/historique/heritage-models/25-1800es  /lu/v/discover/heritage-car-models#1800es *
/lu/modeles/historique/heritage-models/26-242  /lu/v/discover/heritage-car-models#242 *
/lu/modeles/historique/heritage-models/27-244  /lu/v/discover/heritage-car-models#244 *
/lu/modeles/historique/heritage-models/28-245  /lu/v/discover/heritage-car-models#245 *
/lu/modeles/historique/heritage-models/29-262  /lu/v/discover/heritage-car-models#262 *
/lu/modeles/historique/heritage-models/3-tr671-9  /lu/v/discover/heritage-car-models#360-berline *
/lu/modeles/historique/heritage-models/30-262c  /lu/v/discover/heritage-car-models#262c *
/lu/modeles/historique/heritage-models/32-265  /lu/v/discover/heritage-car-models#265 *
/lu/modeles/historique/heritage-models/33-240  /lu/v/discover/heritage-car-models#240 *
/lu/modeles/historique/heritage-models/35-66  /lu/v/discover/heritage-car-models#260 *
/lu/modeles/historique/heritage-models/36-343  /lu/v/discover/heritage-car-models#66 *
/lu/modeles/historique/heritage-models/37-345  /lu/v/discover/heritage-car-models#343 *
/lu/modeles/historique/heritage-models/38-360-3-d  /lu/v/discover/heritage-car-models#345 *
/lu/modeles/historique/heritage-models/39-360-sedan  /lu/v/discover/heritage-car-models#360-3-d *
/lu/modeles/historique/heritage-models/4-pv653-9  /lu/v/discover/heritage-car-models#pv653-9 *
/lu/modeles/historique/heritage-models/40-360-5-d  /lu/v/discover/heritage-car-models#360-5-d *
/lu/modeles/historique/heritage-models/41-760-sedan  /lu/v/discover/heritage-car-models#760-berline *
/lu/modeles/historique/heritage-models/42-760-estate  /lu/v/discover/heritage-car-models#760-break *
/lu/modeles/historique/heritage-models/43-740-sedan  /lu/v/discover/heritage-car-models#740-berline *
/lu/modeles/historique/heritage-models/44-740-estate  /lu/v/discover/heritage-car-models#740-break *
/lu/modeles/historique/heritage-models/45-780  /lu/v/discover/heritage-car-models#780 *
/lu/modeles/historique/heritage-models/46-480  /lu/v/discover/heritage-car-models#480 *
/lu/modeles/historique/heritage-models/47-440  /lu/v/discover/heritage-car-models#440 *
/lu/modeles/historique/heritage-models/48-460  /lu/v/discover/heritage-car-models#460 *
/lu/modeles/historique/heritage-models/49-940-sedan  /lu/v/discover/heritage-car-models#940-berline *
/lu/modeles/historique/heritage-models/51-960-sedan  /lu/v/discover/heritage-car-models#960-berline *
/lu/modeles/historique/heritage-models/52-960-estate  /lu/v/discover/heritage-car-models#960-break *
/lu/modeles/historique/heritage-models/55-850-sedan  /lu/v/discover/heritage-car-models#850-berline *
/lu/modeles/historique/heritage-models/57-850-estate  /lu/v/discover/heritage-car-models#850-break *
/lu/modeles/historique/heritage-models/58-v70-v70xc-classic  /lu/v/discover/heritage-car-models#v70-v70xc-classic *
/lu/modeles/historique/heritage-models/6-pv36-carioca  /lu/v/discover/heritage-car-models#pv36-carioca *
/lu/modeles/historique/heritage-models/60-v40  /lu/v/discover/heritage-car-models#v40 *
/lu/modeles/historique/heritage-models/61-c70-coupe  /lu/v/discover/heritage-car-models#c70-coupé *
/lu/modeles/historique/heritage-models/62-c70-cabriolet-convertible  /lu/v/discover/heritage-car-models#c70-cabriolet-convertible *
/lu/modeles/historique/heritage-models/68-v50  /lu/v/discover/heritage-car-models#v50 *
/lu/modeles/historique/heritage-models/7-pv51-7  /lu/v/discover/heritage-car-models#pv51-7 *
/lu/modeles/historique/heritage-models/9-pv60-1  /lu/v/discover/heritage-car-models#pv60-1 *
/lu/modeles/historique/innovations	/lu/v/car-safety/safety-heritage	*
/lu/modeles/volvo-recall  /lu/v/own/recall  *
/lu/modeles/volvo-selekt	/lu/l/volvo-selekt/	*
/il/cars/emission-safety  https://media.volvo-israel.co.il/2022/volvocarsemissionandsafety/  *
/lu/modeles  /lu/l/modeles/  *

## modelle namespace

##Expiry 2023-04-15
/de/modelle/neuwagen/s90/ausstattungslinien/momentum-pro 	/de/cars/s90/  *
/de/modelle/neuwagen/s90/ausstattungslinien/momentum 	/de/cars/s90/  *
/de/modelle/neuwagen/Volvo-macht-gluecklich/Ausstattungspraemie 	/de/l/beratung-und-kauf/neuwagen/  *
/de/Modelle/Neuwagen/V40 	/de/l/beratung-und-kauf/neuwagen/  *
/de/modelle/neuwagen/v40/wo-beginnt-luxus 	/de/l/beratung-und-kauf/neuwagen/  *
/de/modelle/neue-modelle/der-neue-xc90 	/de/cars/xc90-hybrid/  *
/de/modelle/neue-modelle/s60 	/de/cars/s60-hybrid/  *
/de/modelle/neue-modelle/s80 	/de/l/beratung-und-kauf/neuwagen/  *
/de/modelle/neue-modelle/v40 	/de/l/beratung-und-kauf/neuwagen/  *
/de/modelle/neue-modelle/v40-cross-country 	/de/l/beratung-und-kauf/neuwagen/  *
/de/modelle/neue-modelle/v60  /de/cars/v60/  *
/de/modelle/neue-modelle/v70  /de/l/beratung-und-kauf/neuwagen/  *
/de/modelle/neue-modelle/xc60 	/de/cars/xc60-hybrid/  *
/de/modelle/neue-modelle/xc70 	/de/l/beratung-und-kauf/neuwagen/  *
/de/modelle/concept-cars/concept-coupe 	/de/l/beratung-und-kauf/neuwagen/  *
/de/Modelle/Schwedenflotte-auf-Sylt 	/de/l/beratung-und-kauf/mietwagen/  *
/de/modelle/neuwagen/der-neue-xc90  /de/cars/xc90-hybrid/  *
/de/modelle/neuwagen/s60/galerie 	/de/cars/s60/  *
/de/modelle/neuwagen/s80 	/de/  *
/de/modelle/neuwagen/v40-cross- 	/de/  *
/de/modelle/neuwagen/v40/galerie 	/de/  *
/de/modelle/neuwagen/v40/technische-daten 	/de/  *
/de/modelle/neuwagen/v60/galerie 	/de/cars/v60/  *
/de/modelle/neuwagen/v70 	/de/  *
/de/modelle/neuwagen/xc70 	/de/  *
/de/modelle/neuwagen/xc70/technische-daten 	/de/  *
/de/modelle/neuwagen/der-neue-volvo-v90 	/de/cars/v90/  *
/de/modelle/neuwagen/der-neue-volvo-v90/ausstattungslinien/der-neue-volvo-v90-cross-country 	/de/cars/v90-cross-country/  *
/de/modelle/neuwagen/s90/ausstattungslinien/r-design 	/de/cars/s90/  *
/de/modelle/neuwagen/s90/ausstattungslinien/serienausstattungen 	/de/cars/s90/  *
/de/modelle/neuwagen/der-neue-volvo-s90 	/de/cars/s90/  *
/de/modelle/neuwagen/der-neue-volvo-v90/Ausstattungslinien/Cross-Country 	/de/cars/v90-cross-country/  *
/de/modelle/neuwagen/der-neue-volvo-v90/ 	/de/cars/v90/  *
/de/modelle/neuwagen/v90/ausstattungslinien/serienausstattungen/der-volvo-v90-cross-country 	/de/cars/v90-cross-country/  *
/de/modelle/neuwagen/xc40/zubehoer/technische-daten 	/de/cars/xc40/  *
/de/modelle/neuwagen/der-neue-volvo-xc60/stories/skandinavisches-design 	/de/cars/xc60-hybrid/  *
/de/modelle/neuwagen/xc60/stories/skandinavisches-design 	/de/cars/xc60-hybrid/  *

/de/modelle/cross-country  /de/  *
/de/modelle/kombi	 /de/v/cars/wagon  *
/de/modelle/limousine	/de/v/cars/sedan  *
/de/modelle/neuwagen/der-neue-volvo-xc40/360-tour	 /de/cars/xc40/  *
/de/modelle/neuwagen/der-neue-volvo-xc40/ausstattungslinien	 /de/cars/xc40/  *
/de/modelle/neuwagen/der-neue-volvo-xc40/ausstattungslinien/serienausstattung	 /de/cars/xc40/  *
/de/modelle/neuwagen/der-neue-volvo-xc40/typisch-volvo-typisch-anders	 /de/cars/xc40/  *
/de/modelle/neuwagen/der-neue-volvo-xc40  /de/cars/xc40-hybrid/  *
/de/modelle/neuwagen/der-neue-volvo-xc60  /de/cars/xc60-hybrid/  *
/de/modelle/neuwagen/der-neue-volvo-xc60/galerie	 /de/cars/xc60-hybrid/  *
/de/modelle/neuwagen/plug-in-hybrid	 /de/v/cars/recharge  *
/de/modelle/neuwagen/s60	 /de/cars/s60-hybrid/  *
/de/modelle/neuwagen/s60/ausstattungslinien	 /de/cars/s60  *
/de/modelle/neuwagen/s60/ausstattungslinien/inscription	 /de/cars/s60  *
/de/modelle/neuwagen/s60/ausstattungslinien/momentum	 /de/cars/s60  *
/de/modelle/neuwagen/s60/ausstattungslinien/polestar	 /de/cars/s60-hybrid  *
/de/modelle/neuwagen/s60/ausstattungslinien/r-design	 /de/cars/s60  *
/de/modelle/neuwagen/s60/recharge-plug-in-hybrid	 /de/cars/s60-hybrid  *
/de/modelle/neuwagen/s60/technische-daten	 /de/cars/s60/  *
/de/modelle/neuwagen/s60/twin-engine	 /de/cars/s60-hybrid/  *
/de/modelle/neuwagen/s60/zubehoer	 /de/cars/s60/  *
/de/modelle/neuwagen/s90	 /de/cars/s90-hybrid/  *
/de/modelle/neuwagen/s90/ausstattungslinien	 /de/cars/s90/  *
/de/modelle/neuwagen/s90/inscription	 /de/cars/s90/  *
/de/modelle/neuwagen/s90/momentum-pro	 /de/cars/s90/  *
/de/modelle/neuwagen/s90/r-design	 /de/cars/s90/  *
/de/modelle/neuwagen/s90/recharge-plug-in-hybrid  /de/cars/s90-hybrid/  *
/de/modelle/neuwagen/s90/serienausstattungen  /de/cars/s90/  *
/de/modelle/neuwagen/s90/technische-daten	 /de/cars/s90/  *
/de/modelle/neuwagen/s90/technische-daten-neu	 /de/cars/s90/  *
/de/modelle/neuwagen/s90/twin-engine	 /de/cars/s90-hybrid/  *
/de/modelle/neuwagen/v60	 /de/cars/v60-hybrid  *
/de/modelle/neuwagen/v60/ausstattungslinien	 /de/cars/v60/  *
/de/modelle/neuwagen/v60/ausstattungslinien/cross-country	 /de/cars/v60-cross-country/  *
/de/modelle/neuwagen/v60/ausstattungslinien/inscription	 /de/cars/v60/  *
/de/modelle/neuwagen/v60/ausstattungslinien/polestar-engineered	 /de/cars/v60-hybrid/  *
/de/modelle/neuwagen/v60/ausstattungslinien/r-design	 /de/cars/v60/  *
/de/modelle/neuwagen/v60/ausstattungslinien/serienausstattungen	 /de/cars/v60/  *
/de/modelle/neuwagen/v60/beschuetzt-was-ihnen-wichtig-ist	 /de/cars/v60/  *
/de/modelle/neuwagen/v60/cross-country	 /de/cars/v60-cross-country/  *
/de/modelle/neuwagen/v60/recharge-plug-in-hybrid	 /de/cars/v60-hybrid/  *
/de/modelle/neuwagen/v60/technische-daten	 /de/cars/v60/  *
/de/modelle/neuwagen/v60/twin-engine	 /de/cars/v60-hybrid/  *
/de/modelle/neuwagen/v60/zubehoer	 /de/cars/v60  *
/de/modelle/neuwagen/v90	 /de/cars/v90-hybrid/  *
/de/modelle/neuwagen/v90/ausstattungslinien	 /de/cars/v90/  *
/de/modelle/neuwagen/v90/ausstattungslinien/inscription	 /de/cars/v90/  *
/de/modelle/neuwagen/v90/ausstattungslinien/momentum	 /de/cars/v90/  *
/de/modelle/neuwagen/v90/ausstattungslinien/r-design	 /de/cars/v90/  *
/de/modelle/neuwagen/v90/ausstattungslinien/v90-cross-country	 /de/cars/v90-cross-country/  *
/de/modelle/neuwagen/v90/cross-country	 /de/cars/v90-cross-country/  *
/de/modelle/neuwagen/v90/recharge-plug-in-hybrid	 /de/cars/v90-hybrid/  *
/de/modelle/neuwagen/v90/technische-daten	 /de/cars/v90/  *
/de/modelle/neuwagen/v90/twin-engine	 /de/cars/v90-hybrid/  *
/de/modelle/neuwagen/v90/zubehoer	 /de/cars/v90/  *
/de/modelle/neuwagen/xc40	 /de/cars/xc40-hybrid/  *
/de/modelle/neuwagen/xc40/360-tour	 /de/cars/xc40/  *
/de/modelle/neuwagen/xc40/ausstattungslinien	 /de/cars/xc40/  *
/de/modelle/neuwagen/xc40/ausstattungslinien/inscription	 /de/cars/xc40/  *
/de/modelle/neuwagen/xc40/ausstattungslinien/r-design	 /de/cars/xc40/  *
/de/modelle/neuwagen/xc40/ausstattungslinien/serienausstattung	 /de/cars/xc40/  *
/de/modelle/neuwagen/xc40/recharge	 /de/cars/xc40-hybrid/  *
/de/modelle/neuwagen/xc40/recharge/plug-in-hybrid	 /de/cars/xc40-hybrid/  *
/de/modelle/neuwagen/xc40/technische-daten	 /de/cars/xc40/  *
/de/modelle/neuwagen/xc40/typisch-volvo-typisch-anders	 /de/cars/xc40-hybrid/  *
/de/modelle/neuwagen/xc40/zubehoer	 /de/cars/xc40/  *
/de/modelle/neuwagen/xc60	 /de/cars/xc60-hybrid/  *
/de/modelle/neuwagen/xc60/ausstattungslinien	 /de/cars/xc60/  *
/de/modelle/neuwagen/xc60/ausstattungslinien/inscription	 /de/cars/xc60/  *
/de/modelle/neuwagen/xc60/ausstattungslinien/momentum	 /de/cars/xc60-hybrid/  *
/de/modelle/neuwagen/xc60/ausstattungslinien/polestar-engineered	 /de/cars/xc60-hybrid/  *
/de/modelle/neuwagen/xc60/ausstattungslinien/r-design	 /de/cars/xc60/  *
/de/modelle/neuwagen/xc60/ausstattungslinien/serienausstattungen	 /de/cars/xc60/  *
/de/modelle/neuwagen/xc60/elektrifizierung	 /de/cars/xc60-hybrid/  *
/de/modelle/neuwagen/xc60/elektrifizierung/mild-hybrid	 /de/cars/xc60/  *
/de/modelle/neuwagen/xc60/galerie	 /de/cars/xc60-hybrid/  *
/de/modelle/neuwagen/xc60/mild-hybrid	 /de/cars/xc60-hybrid/  *
/de/modelle/neuwagen/xc60/mit-sicherheit-weitergedacht/privatkunden-angebot	 /de/cars/xc60-hybrid/  *
/de/modelle/neuwagen/xc60/mit-sicherheit-weitergedacht/probefahren	 /de/cars/xc60-hybrid/  *
/de/modelle/neuwagen/xc60/technische-daten	 /de/cars/xc60  *
/de/modelle/neuwagen/xc60/zubehoer	 /de/cars/xc60/  *
/de/modelle/neuwagen/xc90	 /de/cars/xc90-hybrid/  *
/de/modelle/neuwagen/xc90/ausstattungslinien	 /de/cars/xc90/  *
/de/modelle/neuwagen/xc90/ausstattungslinien/inscription	 /de/cars/xc90/  *
/de/modelle/neuwagen/xc90/ausstattungslinien/momentum	 /de/cars/xc90/  *
/de/modelle/neuwagen/xc90/ausstattungslinien/r-design	 /de/cars/xc90/  *
/de/modelle/neuwagen/xc90/ausstattungslinien/serienausstattungen	 /de/cars/xc90/  *
/de/modelle/neuwagen/xc90/elektrifizierung	 /de/cars/xc90/   *
/de/modelle/neuwagen/xc90/elektrifizierung/mild-hybrid	 /de/cars/xc90/  *
/de/modelle/neuwagen/xc90/recharge-plug-in-hybrid	 /de/cars/xc90-hybrid/  *
/de/modelle/neuwagen/xc90/technische-daten	 /de/cars/xc90/  *
/de/modelle/neuwagen/xc90/twin-engine	 /de/cars/xc90-hybrid/  *
/de/modelle/neuwagen/xc90/zubehoer	 /de/cars/xc90/  *
/de/modelle/suv	 /de/v/cars/suv  *
/de/modelle/suvs	 /de/v/cars/suv  *
/de/modelle/xc40-pure-electric	 /de/cars/xc40-electric/  *
/de/modelle  /de/l/beratung-und-kauf/neuwagen/  *
/de-ch/modelle/geschaeftskunden/flottenmanager  https://www.volvocars-web.ch/de/geschaeftskunden/flottenmanager  *
##Expiry 2023-04-01
/at/modelle/entdecken/plug-in-hybrid  /at/v/cars/plug-in-hybrids  *
/at/modelle/entdecken/schauraum/crosscountry  /at/v/cars/wagon  *
/at/modelle/entdecken/schauraum/kombi  /at/v/cars/wagon  *
/at/modelle/entdecken/schauraum/limousine  /at/v/cars/sedan  *
/at/modelle/entdecken/schauraum/suv  /at/v/cars/suv  *
/at/modelle/unsere-modelle/xc40-full-pdp  /at/cars/xc40/  *
/at/modelle/gebrauchtwagen	/at/l/beratung-und-kauf/kauf/gebrauchtwagen/	*
/at/modelle/schauraum	/at/l/modelle/entdecken/schauraum/  *
/at/modelle/entdecken/schauraum	/at/l/modelle/entdecken/schauraum/  *
/at/modelle/unsere-modelle/s60  /at/v/cars/s60  *
/at/modelle/unsere-modelle/s60-plug-in-hybrid  /at/v/cars/s60-hybrid  *
/at/modelle/unsere-modelle/s60/ausstattungslinien	/at/cars/s60/	*
/at/modelle/unsere-modelle/s60/ausstattungslinien/inscription	/at/cars/s60/	*
/at/modelle/unsere-modelle/s60/ausstattungslinien/momentum	/at/cars/s60/	*
/at/modelle/unsere-modelle/s60/ausstattungslinien/r-design	/at/cars/s60/	*
/at/modelle/unsere-modelle/s60/twin-engine	/at/cars/s60-hybrid/	*
/at/modelle/unsere-modelle/s90-plug-in-hybrid  /at/v/cars/s90-hybrid  *
/at/modelle/unsere-modelle/v60-plug-in-hybrid  /at/v/cars/v60-hybrid  *
/at/modelle/unsere-modelle/v90-plug-in-hybrid  /at/v/cars/v90-hybrid  *
/at/modelle/unsere-modelle/volvo-s90  /at/v/cars/s90  *
/at/modelle/unsere-modelle/volvo-s90/twin-engine	/at/cars/s90-hybrid/	*
/at/modelle/unsere-modelle/volvo-v60  /at/v/cars/v60  *
/at/modelle/unsere-modelle/volvo-v60/ausstattungslinien	/at/v/cars/v60	*
/at/modelle/unsere-modelle/volvo-v60/ausstattungslinien/inscription	/at/v/cars/v60	*
/at/modelle/unsere-modelle/volvo-v60/ausstattungslinien/momentum	/at/v/cars/v60	*
/at/modelle/unsere-modelle/volvo-v60/ausstattungslinien/r-design	/at/v/cars/v60	*
/at/modelle/unsere-modelle/volvo-v60/cross-country  /at/v/cars/v60-cross-country  *
/at/modelle/unsere-modelle/volvo-v60/twin-engine	/at/v/cars/v60-hybrid 	*
/at/modelle/unsere-modelle/volvo-v90  /at/v/cars/v90  *
/at/modelle/unsere-modelle/volvo-v90/ausstattungslinien	/at/v/cars/v90  *
/at/modelle/unsere-modelle/volvo-v90/ausstattungslinien/cross-country	/at/v/cars/v90	*
/at/modelle/unsere-modelle/volvo-v90/ausstattungslinien/inscription	/at/v/cars/v90	*
/at/modelle/unsere-modelle/volvo-v90/ausstattungslinien/momentum	/at/v/cars/v90	*
/at/modelle/unsere-modelle/volvo-v90/ausstattungslinien/r-design	/at/v/cars/v90	*
/at/modelle/unsere-modelle/volvo-v90/cross-country  /at/v/cars/v90-cross-country  *
/at/modelle/unsere-modelle/volvo-v90/twin-engine	/at/v/cars/v90-hybrid	*
/at/modelle/unsere-modelle/volvo-xc60  /at/v/cars/xc60  *
/at/modelle/unsere-modelle/volvo-xc60/twin-engine	/at/v/cars/xc60-hybrid	*
/at/modelle/unsere-modelle/volvo-xc90  /at/v/cars/xc90  *
/at/modelle/unsere-modelle/volvo-xc90/ausstattungslinien	/at/v/cars/xc90	*
/at/modelle/unsere-modelle/volvo-xc90/ausstattungslinien/inscription	/at/v/cars/xc90	*
/at/modelle/unsere-modelle/volvo-xc90/ausstattungslinien/momentum	/at/v/cars/xc90	*
/at/modelle/unsere-modelle/volvo-xc90/ausstattungslinien/r-design	/at/v/cars/xc90	*
/at/modelle/unsere-modelle/xc40  /at/v/cars/xc40  *
/at/modelle/unsere-modelle/xc40-plug-in-hybrid  /at/v/cars/xc40-hybrid  *
/at/modelle/unsere-modelle/xc40/twin-engine	/at/v/cars/xc40-hybrid	*
/at/modelle/unsere-modelle/xc60-plug-in-hybrid  /at/v/cars/xc60-hybrid  *
/at/modelle/unsere-modelle/xc90  /at/v/cars/xc90-hybrid  *
/at/modelle/xc40-pure-electric  /at/v/cars/xc40-electric  *
##Expiry 2023-03-30
/de-ch/modelle/volvo-selekt	/de-ch/l/modelle/volvo-selekt/  *
/de-ch/modelle/showroom  /de-ch/l/modelle/showroom/  *
##expiry 2023-04-15
/de-ch/modelle/unsere-modelle/xc40-full-pdp	/de-ch/cars/xc40/  *
/de-ch/modelle/geschaeftskunden/behoerde/stadtpolizei-duebendorf  https://www.volvocars-web.ch/de/geschaeftskunden/behoerden/stadtpolizei-duebendorf  *
/de-ch/modelle/geschaeftskunden/behoerde/kantonspolizei-schwyz  https://www.volvocars-web.ch/de/geschaeftskunden/behoerden/kantonspolizei-schwyz  *
/de-ch/modelle/geschaeftskunden/angebote	/de-ch/  *
/de-ch/modelle/geschaeftskunden/angebote/v60-recharge-for-business	/de-ch/  *
/de-ch/modelle/geschaeftskunden  /de-ch/l/modelle/geschaeftskunden/  *
/fr-ch/modeles/service-flotte  /fr-ch/l/modeles/service-flotte/  *
/de-CH/modelle/concept-cars/concept-coupe	/de-ch/v/cars/concept-models/concept-coupe	*
/de-CH/modelle/occasionen	/de-ch/l/modelle/volvo-selekt/	*
/de-ch/modelle/cross-country  /de-ch/v/cars/wagon *
/de-ch/modelle/geschaeftskunden/behoerde/gepanzerte-fahrzeuge  /de-ch/special-vehicles/	*
/de-ch/modelle/other-powertrains /de-ch/v/cars/other-powertrains  *
/de-ch/modelle/recharge /de-ch/v/cars/recharge *
/de-ch/modelle/s60  /de-ch/v/cars/s60  *
/de-ch/modelle/s60/shop  /de-ch/v/cars/s60/shop  *
/de-ch/modelle/s90  /de-ch/v/cars/s90  *
/de-ch/modelle/s90/shop  /de-ch/v/cars/s90/shop  *
/de-ch/modelle/sedan  /de-ch/v/cars/sedan  *
/de-ch/modelle/suv  /de-ch/v/cars/suv  *
/de-ch/modelle/unsere-modelle/s60  /de-ch/cars/s60-hybrid/ *
/de-ch/modelle/unsere-modelle/s60-twin-engine  /de-ch/v/cars/s60-hybrid  *
/de-ch/modelle/unsere-modelle/s60-twin-engine/downloads  /de-ch/v/cars/s60-hybrid/shop  *
/de-ch/modelle/unsere-modelle/s60/downloads  /de-ch/v/cars/s60-hybrid/shop  *
/de-ch/modelle/unsere-modelle/s60/editionen	/de-ch/cars/s60-hybrid/	*
/de-ch/modelle/unsere-modelle/s60/editionen/inscription	/de-ch/cars/s60-hybrid/	*
/de-ch/modelle/unsere-modelle/s60/editionen/polestar-engineered	/de-ch/cars/s60-hybrid/	*
/de-ch/modelle/unsere-modelle/s60/editionen/r-design	/de-ch/cars/s60-hybrid/	*
/de-ch/modelle/unsere-modelle/s60/shop  /de-ch/v/cars/s60-hybrid/shop  *
/de-ch/modelle/unsere-modelle/s60/technische-daten/editionen-im-vergleich  /de-ch/v/cars/s60-hybrid  *
/de-ch/modelle/unsere-modelle/s90-twin-engine  /de-ch/v/cars/s90-hybrid  *
/de-ch/modelle/unsere-modelle/s90-twin-engine/downloads  /de-ch/v/cars/s90-hybrid/shop  *
/de-ch/modelle/unsere-modelle/v60-twin-engine  /de-ch/v/cars/v60-hybrid  *
/de-ch/modelle/unsere-modelle/v90  /de-ch/v/cars/v90  *
/de-ch/modelle/unsere-modelle/v90-twin-engine  /de-ch/v/cars/v90-hybrid  *
/de-ch/modelle/unsere-modelle/v90-twin-engine/downloads  /de-ch/v/cars/v90-hybrid/shop  *
/de-ch/modelle/unsere-modelle/volvo-s60-twin-engine  /de-ch/v/cars/s60-hybrid  *
/de-ch/modelle/unsere-modelle/volvo-s60-twin-engine/downloads  /de-ch/v/cars/s90-hybrid/shop  *
/de-ch/modelle/unsere-modelle/volvo-s90  /de-ch/cars/s90-hybrid/ *
/de-ch/modelle/unsere-modelle/volvo-s90-twin-engine  /de-ch/v/cars/s90-hybrid  *
/de-ch/modelle/unsere-modelle/volvo-s90-twin-engine/downloads  /de-ch/v/cars/s60-hybrid/shop  *
/de-ch/modelle/unsere-modelle/volvo-s90/downloads  /de-ch/v/cars/s90-hybrid/shop  *
/de-ch/modelle/unsere-modelle/volvo-s90/editionen	/de-ch/cars/s90-hybrid/	*
/de-ch/modelle/unsere-modelle/volvo-s90/editionen/inscription	/de-ch/cars/s90-hybrid/	*
/de-ch/modelle/unsere-modelle/volvo-s90/editionen/momentum	/de-ch/cars/s90-hybrid/	*
/de-ch/modelle/unsere-modelle/volvo-s90/editionen/r-design	/de-ch/cars/s90-hybrid/	*
/de-ch/modelle/unsere-modelle/volvo-s90/shop  /de-ch/v/cars/s90-hybrid/shop  *
/de-ch/modelle/unsere-modelle/volvo-s90/technische-daten/editionen-im-vergleich  /de-ch/v/cars/s90-hybrid  *
/de-ch/modelle/unsere-modelle/volvo-v60  /de-ch/cars/v60-hybrid/ *
/de-ch/modelle/unsere-modelle/volvo-v60-cross-country	/de-ch/cars/v60-cross-country/	*
/de-ch/modelle/unsere-modelle/volvo-v60-twin-engine  /de-ch/cars/v60-hybrid/  *
/de-ch/modelle/unsere-modelle/volvo-v60-twin-engine/downloads  /de-ch/v/cars/v60-hybrid/shop  *
/de-ch/modelle/unsere-modelle/volvo-v60/cross-country  /de-ch/cars/v60-cross-country/  *
/de-ch/modelle/unsere-modelle/volvo-v60/cross-country/shop  /de-ch/v/cars/v60-cross-country/shop  *
/de-ch/modelle/unsere-modelle/volvo-v60/downloads  /de-ch/v/cars/v60-hybrid/shop  *
/de-ch/modelle/unsere-modelle/volvo-v60/editionen	/de-ch/cars/v60-hybrid/	*
/de-ch/modelle/unsere-modelle/volvo-v60/editionen/cross-country	/de-ch/cars/v60-cross-country/	*
/de-ch/modelle/unsere-modelle/volvo-v60/editionen/inscription	/de-ch/cars/v60-hybrid/	*
/de-ch/modelle/unsere-modelle/volvo-v60/editionen/momentum	/de-ch/cars/v60-hybrid/	*
/de-ch/modelle/unsere-modelle/volvo-v60/editionen/polestar-engineered	/de-ch/cars/v60-hybrid/	*
/de-ch/modelle/unsere-modelle/volvo-v60/editionen/r-design	/de-ch/cars/v60-hybrid/	*
/de-ch/modelle/unsere-modelle/volvo-v60/editionen/twin-engine	/de-ch/cars/v60-hybrid/	*
/de-ch/modelle/unsere-modelle/volvo-v60/galerie	/de-ch/cars/v60-hybrid/	*
/de-ch/modelle/unsere-modelle/volvo-v60/shop  /de-ch/v/cars/v60-hybrid/shop *
/de-ch/modelle/unsere-modelle/volvo-v60/technische-daten/editionen-im-vergleich  /de-ch/v/cars/v60-hybrid  *
/de-ch/modelle/unsere-modelle/volvo-v90  /de-ch/cars/v90-hybrid/ *
/de-ch/modelle/unsere-modelle/volvo-v90-cross-country	/de-ch/cars/v90-cross-country/	*
/de-ch/modelle/unsere-modelle/volvo-v90-twin-engine  /de-ch/v/cars/v90-hybrid  *
/de-ch/modelle/unsere-modelle/volvo-v90-twin-engine/downloads  /de-ch/v/cars/v90-hybrid/shop  *
/de-ch/modelle/unsere-modelle/volvo-v90/cross-country  /de-ch/cars/v90-cross-country/  *
/de-ch/modelle/unsere-modelle/volvo-v90/cross-country/shop  /de-ch/v/cars/v90-cross-country/shop  *
/de-ch/modelle/unsere-modelle/volvo-v90/downloads  /de-ch/v/cars/v90-hybrid/shop  *
/de-ch/modelle/unsere-modelle/volvo-v90/editionen	/de-ch/cars/v90-hybrid/	*
/de-ch/modelle/unsere-modelle/volvo-v90/editionen/cross-country	/de-ch/cars/v90-cross-country/	*
/de-ch/modelle/unsere-modelle/volvo-v90/editionen/inscription	/de-ch/cars/v90-hybrid/	*
/de-ch/modelle/unsere-modelle/volvo-v90/editionen/momentum	/de-ch/cars/v90-hybrid/	*
/de-ch/modelle/unsere-modelle/volvo-v90/editionen/r-design	/de-ch/cars/v90-hybrid/	*
/de-ch/modelle/unsere-modelle/volvo-v90/editionen/v90-cross-country-volvo-ocean-race	/de-ch/cars/v90-hybrid/	*
/de-ch/modelle/unsere-modelle/volvo-v90/made-by-sweden  /de-ch/v/cars/v90-hybrid  *
/de-ch/modelle/unsere-modelle/volvo-v90/shop  /de-ch/v/cars/v90-hybrid/shop *
/de-ch/modelle/unsere-modelle/volvo-v90/technische-daten/editionen-im-vergleich  /de-ch/v/cars/v90-hybrid  *
/de-ch/modelle/unsere-modelle/volvo-xc40-twin-engine  /de-ch/v/cars/xc40-hybrid  *
/de-ch/modelle/unsere-modelle/volvo-xc40-twin-engine/zeit-umzuschalten  /de-ch/v/cars/xc40-hybrid  *
/de-ch/modelle/unsere-modelle/volvo-xc60  /de-ch/cars/xc60-hybrid/  *
/de-ch/modelle/unsere-modelle/volvo-xc60-twin-engine  /de-ch/v/cars/xc60-hybrid  *
/de-ch/modelle/unsere-modelle/volvo-xc60/downloads  /de-ch/v/cars/xc60-hybrid/shop  *
/de-ch/modelle/unsere-modelle/volvo-xc60/editionen	/de-ch/cars/xc60-hybrid/	*
/de-ch/modelle/unsere-modelle/volvo-xc60/editionen/inscription	/de-ch/cars/xc60-hybrid/	*
/de-ch/modelle/unsere-modelle/volvo-xc60/editionen/momentum	/de-ch/cars/xc60-hybrid/	*
/de-ch/modelle/unsere-modelle/volvo-xc60/editionen/polestar-engineered	/de-ch/cars/xc60-hybrid/	*
/de-ch/modelle/unsere-modelle/volvo-xc60/editionen/r-design	/de-ch/cars/xc60-hybrid/	*
/de-ch/modelle/unsere-modelle/volvo-xc60/moments  /de-ch/v/cars/xc60-hybrid  *
/de-ch/modelle/unsere-modelle/volvo-xc60/shop  /de-ch/v/cars/xc60-hybrid/shop  *
/de-ch/modelle/unsere-modelle/volvo-xc60/stories  /de-ch/v/cars/xc60-hybrid  *
/de-ch/modelle/unsere-modelle/volvo-xc60/stories/audiosystem  /de-ch/v/cars/xc60-hybrid  *
/de-ch/modelle/unsere-modelle/volvo-xc60/stories/cleanzone  /de-ch/v/cars/xc60-hybrid  *
/de-ch/modelle/unsere-modelle/volvo-xc60/stories/design  /de-ch/v/cars/xc60-hybrid  *
/de-ch/modelle/unsere-modelle/volvo-xc60/stories/effortless-ownership  /de-ch/v/cars/xc60-hybrid  *
/de-ch/modelle/unsere-modelle/volvo-xc60/stories/fahrdynamik  /de-ch/v/cars/xc60-hybrid  *
/de-ch/modelle/unsere-modelle/volvo-xc60/stories/hilfreiche-technik  /de-ch/v/cars/xc60-hybrid  *
/de-ch/modelle/unsere-modelle/volvo-xc60/stories/innovation  /de-ch/v/cars/xc60-hybrid  *
/de-ch/modelle/unsere-modelle/volvo-xc60/stories/personalisierung  /de-ch/v/cars/xc60-hybrid  *
/de-ch/modelle/unsere-modelle/volvo-xc60/stories/powered-tailgate  /de-ch/v/cars/xc60-hybrid  *
/de-ch/modelle/unsere-modelle/volvo-xc60/stories/technologie  /de-ch/v/cars/xc60-hybrid  *
/de-ch/modelle/unsere-modelle/volvo-xc60/technische-daten/editionen-im-vergleich  /de-ch/v/cars/xc60-hybrid  *
/de-ch/modelle/unsere-modelle/volvo-xc90  /de-ch/cars/xc90-hybrid/  *
/de-ch/modelle/unsere-modelle/volvo-xc90-twin-engine  /de-ch/v/cars/xc90-hybrid  *
/de-ch/modelle/unsere-modelle/volvo-xc90/ausstattungslinien	/de-ch/cars/xc90-hybrid/	*
/de-ch/modelle/unsere-modelle/volvo-xc90/ausstattungslinien/inscription	/de-ch/cars/xc90-hybrid/	*
/de-ch/modelle/unsere-modelle/volvo-xc90/ausstattungslinien/momentum	/de-ch/cars/xc90-hybrid/	*
/de-ch/modelle/unsere-modelle/volvo-xc90/ausstattungslinien/r-design	/de-ch/cars/xc90-hybrid/	*
/de-ch/modelle/unsere-modelle/volvo-xc90/downloads  /de-ch/v/cars/xc90-hybrid/shop  *
/de-ch/modelle/unsere-modelle/volvo-xc90/elektrifizierung  /de-ch/v/cars/xc90-hybrid  *
/de-ch/modelle/unsere-modelle/volvo-xc90/shop  /de-ch/v/cars/xc90-hybrid/shop  *
/de-ch/modelle/unsere-modelle/volvo-xc90/technische-daten/editionen-im-vergleich  /de-ch/v/cars/xc90-hybrid  *
/de-ch/modelle/unsere-modelle/xc40  /de-ch/  *
/de-ch/modelle/unsere-modelle/xc40-twin-engine  /de-ch/v/cars/xc40-hybrid  *
/de-ch/modelle/unsere-modelle/xc40/360-tour  /de-ch/v/cars/xc40  *
/de-ch/modelle/unsere-modelle/xc40/downloads  /de-ch/v/cars/xc40  *
/de-ch/modelle/unsere-modelle/xc40/editionen	/de-ch/	*
/de-ch/modelle/unsere-modelle/xc40/editionen/inscription	/de-ch/	*
/de-ch/modelle/unsere-modelle/xc40/editionen/momentum	/de-ch/	*
/de-ch/modelle/unsere-modelle/xc40/editionen/r-design	/de-ch/	*
/de-ch/modelle/unsere-modelle/xc40/erster-seiner-art  /de-ch/v/cars/xc40  *
/de-ch/modelle/unsere-modelle/xc40/technische-daten/editionen-im-vergleich  /de-ch/v/cars/xc40  *
/de-ch/modelle/unsere-modelle/xc60-twin-engine  /de-ch/v/cars/xc60-hybrid  *
/de-ch/modelle/unsere-modelle/xc60-twin-engine/downloads  /de-ch/v/cars/xc60-hybrid/shop  *
/de-ch/modelle/unsere-modelle/xc90  /de-ch/v/cars/xc90  *
/de-ch/modelle/v60  /de-ch/v/cars/v60  *
/de-ch/modelle/v60/shop  /de-ch/v/cars/v60/shop  *
/de-ch/modelle/v90  /de-ch/v/cars/v90  *
/de-ch/modelle/v90/shop  /de-ch/v/cars/v90/shop  *
/de-ch/modelle/xc40  /de-ch/v/cars/xc40  *
/de-ch/modelle/xc40-pure-electric  /de-ch/v/cars/xc40-electric  * 
/de-ch/modelle/xc40/shop  /de-ch/v/cars/xc40/shop  *
/de-ch/modelle/xc60  /de-ch/v/cars/xc60  *
/de-ch/modelle/xc60/shop  /de-ch/v/cars/xc60/shop  *
/de-ch/modelle/xc90  /de-ch/v/cars/xc90  *
/de-ch/modelle/xc90/shop  /de-ch/v/cars/xc90/shop  *


## modelos namespace
/cl/modelos/recharge  /cl/v/cars/recharge  *
/ar/modelos/new-models/xc40  /ar/v/cars/xc40  *
/ar/modelos/new-models/xc60  /ar/cars/xc60  *
/ar/modelos/new-models/xc90  /ar/v/cars/xc90  *
/cl/modelos/new-models/s60  /cl/v/cars/s60  *
/cl/modelos/new-models/s60-t8-recharge-plug-in-hybrid  /cl/v/cars/s60-hybrid  *
/cl/modelos/new-models/xc40  /cl/v/cars/xc40  *
/cl/modelos/new-models/xc40-t5-recharge-plug-in-hybrid  /cl/v/cars/xc40-hybrid  *
/cl/modelos/new-models/xc60  /cl/v/cars/xc60  *
/cl/modelos/new-models/xc60-t8-recharge-plug-in-hybrid  /cl/v/cars/xc60-hybrid  *
/cl/modelos/new-models/xc90  /cl/v/cars/xc90  *
/cl/modelos/new-models/xc90-t8-recharge-plug-in-hybrid  /cl/v/cars/xc90-hybrid  *
/cl/modelos/recharge/charging-your-volvo  /cl/v/cars/recharge	*


## mobile namespace
##Expiry 2023-02-15
/my/mobile/all-cars/volvo-s60-new	/my/cars/s60-hybrid/	*
/my/mobile/all-cars/volvo-s60-new/which/pages	/my/cars/s60-hybrid/	*
/my/mobile/all-cars/volvo-xc60	/my/cars/xc60/	*
/my/mobile/all-cars/volvo-xc60/which/pages	/my/cars/xc60/	*
/my/mobile/all-cars/volvo-xc90	/my/cars/xc90/	*
/my/mobile/all-cars/volvo-xc90/which/pages	/my/cars/xc90/	*
##Expiry 2023-04-18
/de-ch/modelle/geschaeftskunden/user-chooser  https://www.volvocars-web.ch/de/geschaeftskunden/user-chooser  *
/de-ch/modelle/unsere-modelle/s60/technische-daten		/de-ch/cars/s60/		*					
/de-ch/modelle/unsere-modelle/s60/technische-daten/abmessungen		/de-ch/cars/s60/	*						
/de-ch/modelle/unsere-modelle/s60/technische-daten/motoren		/de-ch/cars/s60/		*					
/de-ch/modelle/unsere-modelle/volvo-s90/technische-daten		/de-ch/cars/s90/	*						
/de-ch/modelle/unsere-modelle/volvo-s90/technische-daten/motoren		/de-ch/cars/s90/  *							
/de-ch/modelle/unsere-modelle/volvo-v60/technische-daten		/de-ch/cars/v60/	*						
/de-ch/modelle/unsere-modelle/volvo-v60/technische-daten/abmessungen		/de-ch/cars/v60/	*						
/de-ch/modelle/unsere-modelle/volvo-v60/technische-daten/motoren		/de-ch/cars/v60/ *							
/de-ch/modelle/unsere-modelle/volvo-v90/technische-daten		/de-ch/cars/v90/	*						
/de-ch/modelle/unsere-modelle/volvo-v90/technische-daten/abmessungen		/de-ch/cars/v90/	*						
/de-ch/modelle/unsere-modelle/volvo-v90/technische-daten/motoren		/de-ch/cars/v90/		*					
/de-ch/modelle/unsere-modelle/volvo-xc60/technische-daten		/de-ch/cars/xc60/	*						
/de-ch/modelle/unsere-modelle/volvo-xc60/technische-daten/abmessungen		/de-ch/cars/xc60/	*						
/de-ch/modelle/unsere-modelle/volvo-xc60/technische-daten/motoren		/de-ch/cars/xc60/		*					
/de-ch/modelle/unsere-modelle/volvo-xc90/technische-daten		/de-ch/cars/xc90/		*					
/de-ch/modelle/unsere-modelle/volvo-xc90/technische-daten/abmessungen		/de-ch/cars/xc90/		*					
/de-ch/modelle/unsere-modelle/volvo-xc90/technische-daten/motoren		/de-ch/cars/xc90/	*						
/de-ch/modelle/unsere-modelle/xc40/technische-daten		/de-ch/cars/xc40/		*					
/de-ch/modelle/unsere-modelle/xc40/technische-daten/abmessungen		/de-ch/cars/xc40/	*						
/de-ch/modelle/unsere-modelle/xc40/technische-daten/motoren		/de-ch/cars/xc40/  *
/de-ch/modelle/geschaeftskunden/behoerde  https://www.volvocars-web.ch/de/geschaeftskunden/behoerden  *
/de-ch/modelle/showroom/  /de-ch/l/modelle/showroom/  *
/de-ch/modelle/concepts-update/concept-40   /de-ch/v/cars/concept-models/concept-40  *
/de-ch/modelle/concepts-update/concept-coupe  /de-ch/v/cars/concept-models/concept-coupe  *
/de-ch/modelle/concepts-update/concept-estate  /de-ch/v/cars/concept-models/concept-estate  *
/de-ch/modelle/concepts-update/concept-xc-coupe  /de-ch/v/cars/concept-models/concept-xc-coupe  *
/de-ch/modelle/concept-cars	/de-ch/v/cars/concept-models  *
/de-ch/modelle/concept-cars/360c	/de-ch/v/cars/concept-models/360c  *
/de-ch/modelle/concept-cars/konzept-26  /de-ch/v/cars/concept-models  *
/de-ch/modelle/concept-cars/ambience-interior	/de-ch/v/cars/concept-models/ambience  *
/de-ch/modelle/concept-cars/concept-coupé	/de-ch/v/cars/concept-models/concept-coupe  *
/de-ch/modelle/concept-cars/concept-estate	/de-ch/v/cars/concept-models/concept-estate  *
/de-ch/modelle/concept-cars/concept-xc-coupé	/de-ch/v/cars/concept-models/concept-xc-coupe  *
/de-ch/modelle/concept-cars/konzept-40	/de-ch/v/cars/concept-models/concept-40  *
/si/mobile/all-cars/volvo-s60	/si/cars/s60/	*
/si/mobile/all-cars/volvo-s60/configurator/pages	/si/cars/s60	*
/si/mobile/all-cars/volvo-s60/which/pages	/si/cars/s60/	*
/si/mobile/all-cars/volvo-v60	/si/cars/v60/	*
/si/mobile/all-cars/volvo-v60/configurator/pages	/si/cars/v60/	*
/si/mobile/all-cars/volvo-v60/which/pages	/si/cars/v60/	*
/si/mobile/all-cars/volvo-xc60	/si/cars/xc60/	*
/si/mobile/all-cars/volvo-xc60/configurator/pages	/si/cars/xc60/	*
/si/mobile/all-cars/volvo-xc60/which/pages	/si/cars/xc60/	*
/hr/mobile/all-cars/volvo-s60	/hr/cars/s60	*
/hr/mobile/all-cars/volvo-s60/which/pages	/hr/cars/s60	*
/hr/mobile/all-cars/volvo-v60	/hr/cars/v60	*
/hr/mobile/all-cars/volvo-v60/configurator/pages	/hr/cars/v60/	*
/hr/mobile/all-cars/volvo-v60/which/pages	/hr/cars/v60/	*
/hr/mobile/all-cars/volvo-xc60	/hr/cars/xc60/	*
/hr/mobile/all-cars/volvo-xc60/configurator/pages	/hr/cars/xc60/	*
/hr/mobile/all-cars/volvo-xc60/which/pages	/hr/cars/xc60/	*
/mx/mobile/all-cars/volvo-s60	/mx/cars/s60	*
/mx/mobile/all-cars/volvo-s60/which/pages	/mx/cars/s60	*
##Expiry 2023-04-01
/jp/mobile/all-cars/volvo-s60	/jp/cars/s60-hybrid/	*
/jp/mobile/all-cars/volvo-s60/which/pages	/jp/cars/s60-hybrid/	*
/jp/mobile/all-cars/volvo-v60	/jp/cars/v60-hybrid/	*
/jp/mobile/all-cars/volvo-v60/which/pages	/jp/cars/v60-hybrid/	*
/jp/mobile/all-cars/volvo-xc60	/jp/cars/xc60-hybrid/	*
/jp/mobile/all-cars/volvo-xc60/which/pages	/jp/cars/xc60-hybrid/	*
/jp/mobile/all-cars/volvo-xc90	/jp/cars/xc90-hybrid/	*
/jp/mobile/all-cars/volvo-xc90/which/pages	/jp/cars/xc90-hybrid/	*
/it/mobile/all-cars/volvo-s60	/it/cars/s60-hybrid/	*
/it/mobile/all-cars/volvo-v60	/it/cars/v60-hybrid/	*
/it/mobile/all-cars/volvo-xc60	/it/cars/xc60-hybrid/	*
/au/mobile/All-Cars	/au/l/model-lineup/	*
/au/mobile/All-Cars/Volvo-S40	/au/l/model-lineup/	*
/de-CH/mobile/all-cars/all-new-volvo-xc90	/de-ch/cars/xc90-hybrid/	*
/de-CH/mobile/all-cars/all-new-volvo-xc90/which/pages	/de-ch/cars/xc90-hybrid/	*
/de-CH/mobile/all-cars/volvo-v60	/de-ch/cars/v60-hybrid/	*
/de-CH/mobile/all-cars/volvo-v60/v60-plug-in-hybrid/pages	/de-ch/cars/v60-hybrid/	*
/de-CH/mobile/all-cars/volvo-v60/which/pages	/de-ch/cars/v60-hybrid/	*
/de-CH/mobile/all-cars/volvo-xc60	/de-ch/cars/xc60-hybrid/	*
/de-CH/mobile/all-cars/volvo-xc60/which/pages	/de-ch/cars/xc60-hybrid/	*
/dk/mobile/all-cars/volvo-s60	/dk/cars/s60-hybrid/	*
/dk/mobile/all-cars/volvo-s60/which/pages	/dk/cars/s60-hybrid/	*
/dk/mobile/all-cars/volvo-v60	/dk/cars/v60-hybrid/	*
/dk/mobile/all-cars/volvo-v60/which/pages	/dk/cars/v60-hybrid/	*
/dk/mobile/all-cars/volvo-xc60	/dk/cars/xc60-hybrid/	*
/dk/mobile/all-cars/volvo-xc60/which/pages	/dk/cars/xc60-hybrid/	*
/fr-CH/mobile/all-cars/all-new-volvo-xc90	/fr-ch/cars/xc90-hybrid/	*
/fr-CH/mobile/all-cars/all-new-volvo-xc90/which/pages	/fr-ch/cars/xc90-hybrid/	*
/fr-CH/mobile/all-cars/volvo-v60	/fr-ch/cars/v60-hybrid/	*
/fr-CH/mobile/all-cars/volvo-v60/which/pages	/fr-ch/cars/v60-hybrid/	*
/fr-CH/mobile/all-cars/volvo-xc60	/fr-ch/cars/xc60-hybrid/	*
/fr-CH/mobile/all-cars/volvo-xc60/which/pages	/fr-ch/cars/xc60-hybrid/	*
/uk/mobile/all-cars/volvo-s60	/uk/cars/s60/	*
/uk/mobile/all-cars/volvo-s60/which/pages	/uk/cars/s60/	*
/uk/mobile/all-cars/volvo-v40-cross-country/which/pages	/uk/l/used-cars/  *
/uk/mobile/all-cars/volvo-v40/which/pages	/uk/l/used-cars/	*
/uk/mobile/all-cars/volvo-v60	/uk/cars/v60/	*
/uk/mobile/all-cars/volvo-v60/which/pages	/uk/cars/v60/	*
/uk/mobile/all-cars/volvo-v70/which/pages	/uk/cars/v90/  *
/uk/mobile/all-cars/volvo-xc60	/uk/cars/xc60/	*
/uk/mobile/all-cars/volvo-xc60/which/pages	/uk/cars/new-models/xc60/specifications	*
/uk/mobile/all-cars/volvo-xc70	/uk/cars/v90/	*
/uk/mobile/all-cars/volvo-xc70/which/pages	/uk/cars/v90/	*
/zh-CN/mobile/all-cars/all-new-volvo-xc90	/zh-cn/cars/xc90/	*
/zh-CN/mobile/all-cars/volvo-s60	/zh-cn/cars/s60/	*
/zh-CN/mobile/all-cars/volvo-s60/which/pages	/zh-cn/cars/s60/	*
/zh-CN/mobile/all-cars/volvo-v60	/zh-cn/cars/v60/	*
/zh-CN/mobile/all-cars/volvo-v60/which/pages	/zh-cn/cars/v60/	*
/zh-CN/mobile/all-cars/volvo-xc60	/zh-cn/cars/xc60/	*
/zh-CN/mobile/all-cars/volvo-xc60/which/pages	/zh-cn/cars/xc60/	*
/zh-CN/mobile/all-cars/volvo-xc90	/zh-cn/cars/xc60/	*
/zh-CN/mobile/all-cars/volvo-xc90/which/pages	/zh-cn/cars/xc60/	*
/kr/mobile/all-cars/volvo-s60	/kr/cars/s60/	*
/kr/mobile/all-cars/volvo-s60/which/pages	/kr/cars/s60/	*
##Expiry 2023-04-15
/th/mobile	/th/	*


##Expiry 2023-05-15
/al/cars/concept-cars/concept-coupe	 /al/v/cars/concept-models/concept-coupe  *
/al/cars/concept-cars/concept-estate  /al/v/cars/concept-models/concept-estate  *
/al/cars/concept-cars/concept-xc-coupe  /al/v/cars/concept-models/concept-xc-coupe  *
/al/cars/concept-cars  /al/v/cars/concept-models  *
/do/cars/concepts  /do/v/cars/concept-models  *
/gt/cars/concepts/ambience-interior	 /gt/v/cars/concept-models/ambience  *
/gt/cars/concepts 	/gt/v/cars/concept-models  *
/hk/cars/concepts/concept-coupe	/hk/v/cars/concept-models/concept-coupe *
/hk/cars/concepts/concept-estate	/hk/v/cars/concept-models/concept-estate *
/hk/cars/concepts/concept-xc	/hk/v/cars/concept-models/concept-xc-coupe *
/hk/cars/concepts	/hk/v/cars/concept-models *
/il/cars/concept-cars/360c  /il/v/cars/concept-models/360c  *
/il/cars/concept-cars/concept-coupe 	/il/v/cars/concept-models/concept-coupe  *
/il/cars/concept-cars/concept-estate	 /il/v/cars/concept-models/concept-estate  *
/il/cars/concept-cars/concept-xc-coupe	 /il/v/cars/concept-models/concept-xc-coupe  *
/il/cars/concept-cars 	/il/v/cars/concept-models  *
/nz/cars/concept-cars/concept-estate	 /nz/v/cars/concept-models/concept-estate  *
/nz/cars/concept-cars	 /nz/v/cars/concept-models  *
/pa/cars/concepts/360c	/pa/v/cars/concept-models/360c  *
/pa/cars/concepts/concept-40  /pa/v/cars/concept-models/concept-40  *
/pa/cars/concepts/concept-coupe	 /pa/v/cars/concept-models/concept-coupe  *
/pa/cars/concepts/concept-estate  /pa/v/cars/concept-models/concept-estate  *
/pa/cars/concepts	 /pa/v/cars/concept-models  *
/pe/cars/modelos-conceptuales/concept-coupe	 /pe/v/cars/concept-models/concept-coupe  *
/pe/cars/modelos-conceptuales/concept-estate	 /pe/v/cars/concept-models/concept-estate  *
/pe/cars/modelos-conceptuales/concept-xc-coupe 	/pe/v/cars/concept-models/concept-xc-coupe  *
/pe/cars/modelos-conceptuales	 /pe/v/cars/concept-models  *
/ph/cars/concept-cars/concept-coupe	/ph/v/cars/concept-models/concept-coupe *
/ph/cars/concept-cars 	/ph/v/cars/concept-models *
/sg/cars/concept-cars/concept-coupe  /sg/v/cars/concept-models/concept-coupe  *
/sg/cars/concept-cars/concept-estate  /sg/v/cars/concept-models/concept-estate  *
/sg/cars/concept-cars/concept-xc-coupe  /sg/v/cars/concept-models/concept-xc-coupe  *
/sg/cars/concept-cars  /sg/v/cars/concept-models  *
/za/cars/concept-cars	 /za/v/cars/concept-models  *
/uy/cars/concepts/360c  /uy/v/cars/concept-models/360c  *
/uy/cars/concepts/ambience-interior  /uy/v/cars/concept-models/ambience  *
/uy/cars/concepts/concept-40  /uy/v/cars/concept-models/concept-40  *
/uy/cars/concepts/concept-coupe  /uy/v/cars/concept-models/concept-coupe  *
/uy/cars/concepts/concept-estate  /uy/v/cars/concept-models/concept-estate  *
/uy/cars/concepts/concept-xc  /uy/v/cars/concept-models/concept-xc-coupe  *
/uy/cars/concepts  /uy/v/cars/concept-models  *

##Expiry 2023-05-15
/gr/cars/heritage/heritage-models		/gr/v/discover/heritage-car-models    *
/pt/cars/xc40-hybrid/specification/  /pt/  *

/nz/cars/electromobility/range  /nz/cars/electrification/range/  *	
/en-th/cars/electromobility/range  /en-th/cars/electrification/range/  *
/th-th/cars/electromobility/range  /th-th/cars/electrification/range/  *
/at/cars/electromobility/range  /at/cars/electrification/range/  *
/nl-be/cars/electromobility/range  /nl-be/cars/electrification/range/  *
/fr-be/cars/electromobility/range  /fr-be/cars/electrification/range/  *
/cz/cars/electromobility/range  /cz/cars/electrification/range/  *
/de/cars/electromobility/range  /de/cars/electrification/range/  *
/is/cars/electromobility/range  /is/cars/electrification/range/  *
/ie/cars/electromobility/range  /ie/cars/electrification/range/  *
/lu/cars/electromobility/range  /lu/cars/electrification/range/  *
/nl/cars/electromobility/range  /nl/cars/electrification/range/  *
/uk-ua/cars/electromobility/range  /uk-ua/cars/electrification/range/  *
/ar-ae/cars/electromobility/range  /ar-ae/cars/electrification/range/  *
/en-ae/cars/electromobility/range  /en-ae/cars/electrification/range/  *
/br/cars/electromobility/cost-benefits  /br/cars/electrification/cost-benefits/  *
/at/cars/electromobility/cost-benefits  /at/cars/electrification/cost-benefits/  *
/nl-be/cars/electromobility/cost-benefits  /nl-be/cars/electrification/cost-benefits/  *
/fr-be/cars/electromobility/cost-benefits  /fr-be/cars/electrification/cost-benefits/  *
/cz/cars/electromobility/cost-benefits  /cz/cars/electrification/cost-benefits/  *	
/fi/cars/electromobility/cost-benefits  /fi/cars/electrification/cost-benefits/  *
/fr/cars/electromobility/cost-benefits  /fr/cars/electrification/cost-benefits/  *
/de/cars/electromobility/cost-benefits  /de/cars/electrification/cost-benefits/  *
/is/cars/electromobility/cost-benefits  /is/cars/electrification/cost-benefits/  *
/lu/cars/electromobility/cost-benefits  /lu/cars/electrification/cost-benefits/  *
/nl/cars/electromobility/cost-benefits  /nl/cars/electrification/cost-benefits/  *
/pl/cars/electromobility/cost-benefits  /pl/cars/electrification/cost-benefits/  *
/es/cars/electromobility/cost-benefits  /es/cars/electrification/cost-benefits/  *
/it-ch/cars/electromobility/cost-benefits  /it-ch/cars/electrification/cost-benefits/  *
/de-ch/cars/electromobility/cost-benefits  /de-ch/cars/electrification/cost-benefits/  *
/fr-ch/cars/electromobility/cost-benefits  /fr-ch/cars/electrification/cost-benefits/  *
/uk/cars/electromobility/cost-benefits  /uk/cars/electrification/cost-benefits/  *
/uk-ua/cars/electromobility/cost-benefits  /uk-ua/cars/electrification/cost-benefits/  *